18
1,7,5,5,5,5,6,2,3,6,3,7,7,7,5,5,5,4
1,15,5,6,1,5,15,14,8,10,10,10,10,9,5,5,5,6
3,13,6,11,5,5,12,10,3,15,14,8,9,5,5,7,7,14
10,3,12,9,7,7,4,11,14,10,11,5,7,5,5,13,12,8
10,10,2,2,10,9,6,10,10,11,12,1,13,7,5,5,5,6
10,9,14,11,12,2,10,10,10,10,2,3,7,13,5,5,7,12
10,3,13,15,4,9,13,14,11,14,11,14,11,5,7,5,13,4
11,12,2,10,3,7,7,15,12,8,10,10,8,1,13,5,5,6
11,4,10,10,10,8,8,10,3,6,11,13,7,7,7,7,5,14
9,6,10,11,14,2,3,14,11,12,11,4,10,10,10,9,6,10
1,14,10,10,10,10,11,15,13,5,13,6,11,14,10,2,10,10
1,13,15,12,9,14,10,10,3,6,2,10,10,11,14,10,10,10
2,3,15,4,2,11,14,11,14,10,11,14,10,10,10,11,14,10
11,14,11,6,10,10,10,10,10,10,11,14,10,10,10,10,9,14
10,10,10,8,11,12,10,10,10,11,14,10,10,10,11,14,3,14
11,14,9,7,13,7,12,10,10,10,10,10,10,10,8,9,12,8
10,10,3,12,3,13,4,8,10,10,8,9,13,13,5,5,5,6
8,9,13,5,13,5,5,5,13,13,5,5,5,5,5,5,5,12
