18
1,5,7,5,5,5,5,7,7,5,5,5,5,5,5,7,6,2
1,7,13,5,7,5,5,13,13,5,7,5,6,3,7,14,10,10
1,14,2,2,11,5,7,5,5,5,13,4,10,10,8,10,8,10
3,14,10,11,13,5,15,6,3,4,1,6,11,14,2,11,6,10
10,11,15,15,6,2,10,11,13,5,5,12,10,11,14,10,11,14
10,8,8,8,11,12,11,13,5,5,5,6,10,8,8,8,10,8
10,1,5,5,13,6,11,5,5,5,5,12,11,5,6,2,11,4
10,1,7,5,5,13,15,7,7,5,5,7,13,5,14,10,9,6
11,7,15,5,5,4,8,10,11,6,1,14,1,5,14,10,3,12
10,10,10,2,3,5,5,12,9,12,3,13,5,7,13,13,15,4
10,10,10,10,9,7,5,5,5,5,15,6,1,14,3,6,9,6
11,14,10,10,3,13,7,5,5,5,12,10,1,14,10,10,3,12
10,10,11,15,14,2,10,3,5,6,3,14,3,13,14,9,13,4
8,9,14,8,10,11,14,10,1,14,10,10,11,5,14,2,2,2
1,7,14,2,10,10,10,10,1,15,14,10,8,1,15,15,15,14
3,12,8,10,9,14,9,14,1,12,10,11,7,5,14,10,10,10
11,5,4,10,3,14,2,9,5,7,15,14,9,4,8,8,10,10
9,5,5,13,12,9,12,1,5,12,8,8,1,5,5,5,12,8
