18
1,7,5,7,6,3,4,2,1,7,7,6,2,2,1,7,6,2
3,12,1,12,9,13,7,13,7,12,8,11,14,10,3,14,10,10
10,3,5,5,5,7,13,5,12,2,2,10,10,11,14,8,11,14
11,14,2,3,5,13,5,7,5,13,13,15,14,10,9,4,8,10
10,9,12,11,5,5,5,13,4,2,3,14,11,14,2,3,6,10
9,5,6,10,3,7,7,5,6,11,14,8,11,15,14,10,9,14
3,6,10,10,10,8,10,3,12,10,9,4,8,8,11,12,1,12
10,10,10,11,13,6,10,9,7,13,5,7,4,3,14,3,4,2
10,11,15,14,2,11,13,6,11,6,1,13,6,8,11,13,5,14
10,10,10,10,10,10,3,14,9,12,2,3,15,5,15,5,4,8
10,10,10,11,14,10,10,11,6,2,11,14,10,3,15,7,5,6
10,11,15,14,11,13,12,8,11,12,10,10,9,12,10,9,4,10
11,12,10,10,10,1,7,5,13,5,12,11,5,7,15,6,2,10
9,6,10,11,14,3,13,5,7,5,5,12,1,12,10,8,11,14
3,12,11,14,11,15,6,1,13,5,5,7,5,5,13,7,14,10
11,5,12,10,8,8,8,1,5,7,5,12,1,5,5,14,8,10
9,7,6,11,7,7,5,5,5,13,5,6,3,5,5,15,5,12
1,12,8,8,9,13,5,5,5,4,1,12,9,5,5,13,5,4
