18
1,7,5,5,5,5,5,5,5,7,7,7,5,5,7,5,5,6
3,15,7,7,7,7,5,7,5,14,8,9,5,5,13,7,4,10
10,10,10,10,10,9,5,15,6,11,5,5,5,7,5,15,5,12
10,10,10,10,10,2,3,14,10,10,2,3,4,10,3,13,7,6
11,14,10,10,10,10,10,10,10,11,15,15,4,10,11,5,15,14
10,10,10,11,14,10,11,14,10,10,10,9,5,14,9,6,10,10
10,9,13,12,9,14,10,10,11,14,11,6,2,11,5,14,10,10
11,4,1,6,3,14,10,11,12,8,8,9,14,10,1,12,10,10
11,5,7,15,14,11,14,10,3,6,3,5,12,9,5,6,8,10
9,6,10,10,10,8,10,11,13,12,11,5,4,1,5,13,5,14
3,12,10,10,10,3,13,15,5,5,13,6,2,1,6,3,5,14
10,3,14,10,10,9,5,15,4,3,4,9,14,3,12,11,6,10
10,10,11,14,11,6,3,13,5,15,5,5,13,15,5,12,8,10
9,12,8,10,8,9,15,5,7,13,5,4,3,14,3,7,6,10
1,6,3,13,5,7,13,5,13,7,5,7,14,10,10,10,10,10
1,14,9,6,3,13,5,5,4,9,6,10,10,9,12,8,9,14
3,14,3,12,10,3,5,5,5,5,12,10,10,3,6,1,7,12
8,9,13,4,9,13,5,5,5,5,4,8,9,12,9,5,13,4
