18
1,6,1,5,7,5,5,4,3,6,2,1,5,7,7,6,3,6
3,15,7,6,10,1,7,5,14,10,11,7,4,10,10,10,10,10
10,10,11,14,11,7,13,4,8,9,14,11,5,14,10,10,10,10
10,10,10,10,10,11,5,5,5,7,13,13,4,11,14,10,11,14
11,14,10,11,15,13,7,5,5,13,5,6,2,10,10,11,14,10
10,9,14,8,10,3,13,5,5,5,5,13,13,14,9,14,8,8
10,1,14,1,13,13,5,7,7,5,7,7,6,9,5,13,5,6
11,7,13,7,7,5,7,13,13,5,14,8,9,5,5,7,5,14
10,10,3,12,10,1,13,6,3,7,15,7,7,5,5,13,5,14
10,10,11,6,11,7,5,12,9,12,8,10,11,7,5,4,1,14
11,14,10,10,10,10,3,5,5,5,5,14,10,9,7,5,5,12
10,10,10,11,14,9,15,5,5,5,5,14,11,5,13,5,6,2
8,11,12,8,10,1,15,4,3,4,1,14,11,5,5,4,10,10
3,13,6,3,14,1,13,6,11,4,3,12,11,5,5,4,11,12
9,6,11,14,11,5,5,13,13,6,11,5,13,7,5,5,14,2
2,10,9,14,9,5,5,7,5,15,13,6,1,13,5,6,11,14
11,12,2,10,3,5,5,12,3,12,3,12,1,7,5,12,8,10
9,4,9,13,13,5,5,5,13,5,13,5,5,13,5,5,5,12
