18
1,6,3,7,5,7,5,5,5,5,7,5,7,5,5,5,7,6
3,15,14,10,1,15,7,6,2,2,11,5,12,2,3,7,14,10
10,10,8,8,3,12,8,11,14,10,11,5,4,10,10,10,10,10
11,15,5,7,13,5,7,12,9,13,13,5,6,11,14,10,10,10
10,10,3,13,5,5,13,5,6,1,5,5,15,12,8,8,10,10
10,9,15,5,5,4,2,2,10,2,3,5,13,5,5,5,14,10
10,3,14,1,7,7,14,11,14,11,14,2,3,7,5,5,13,12
10,10,11,5,12,8,9,14,9,12,10,11,15,13,5,5,5,6
9,12,11,5,5,6,1,14,3,6,11,14,11,5,5,7,5,12
3,5,13,7,5,14,1,15,13,12,10,9,15,5,5,13,5,6
11,5,4,11,4,10,1,15,5,5,15,5,13,5,7,5,5,12
9,7,4,9,6,10,3,14,3,7,15,7,7,7,14,3,5,4
1,13,6,3,12,9,14,8,10,10,10,10,10,8,9,13,5,6
2,3,15,14,3,5,13,6,10,10,10,10,10,2,2,3,6,10
11,14,8,9,14,1,5,14,10,11,15,14,11,15,14,10,10,10
10,11,7,7,14,2,2,11,14,10,10,10,8,8,11,12,10,10
10,8,8,10,9,13,15,12,10,8,10,10,2,3,15,4,10,10
8,1,5,13,5,5,13,4,9,5,12,8,9,12,9,4,9,12
