18
1,7,6,3,5,5,5,5,7,5,6,3,6,2,2,2,3,6
2,10,10,10,2,1,6,3,14,2,11,14,10,11,14,10,10,10
10,10,10,10,10,3,12,10,9,14,8,10,9,12,9,14,10,10
11,14,11,15,14,11,4,10,3,13,7,13,5,5,5,15,12,8
10,10,10,10,10,9,7,14,10,2,10,3,7,6,2,9,7,6
10,11,13,12,11,7,12,10,11,15,14,8,10,11,15,5,12,8
10,9,7,6,10,11,4,10,10,8,9,5,12,10,10,2,2,2
11,6,11,14,11,15,4,11,13,5,6,2,2,10,10,10,11,14
10,11,14,11,14,11,5,14,3,6,10,11,13,12,11,13,12,10
10,8,8,10,10,9,6,10,11,12,10,11,7,6,10,2,3,14
10,2,2,11,14,1,14,10,11,5,12,10,8,10,10,10,10,10
10,10,10,10,9,5,15,15,15,5,7,12,1,13,14,11,14,10
11,15,15,12,2,2,11,14,10,2,9,7,7,5,13,12,8,8
10,8,11,4,11,12,10,10,11,14,3,12,9,5,7,5,5,4
10,3,13,4,10,3,14,11,12,11,13,4,3,5,13,5,5,6
10,10,2,3,13,12,10,10,1,15,5,4,11,5,5,5,5,14
10,9,13,14,1,5,14,10,3,15,7,4,9,5,5,5,7,14
8,1,5,12,1,5,13,13,12,8,9,5,5,5,5,5,13,12
