18
1,6,3,5,6,3,5,7,5,5,7,5,5,7,5,5,6,2
1,15,12,1,13,14,1,13,7,5,13,7,5,15,7,6,10,10
2,11,7,7,6,10,3,5,15,4,3,13,4,9,14,10,10,10
11,14,8,10,9,12,11,5,15,5,13,5,6,2,10,10,11,14
10,10,2,11,5,4,9,5,15,5,5,6,10,10,11,15,14,10
10,10,10,9,6,3,4,3,13,5,5,15,15,12,10,10,11,14
11,15,12,3,13,15,4,11,6,3,6,10,9,6,10,10,10,8
10,9,6,9,6,11,4,10,9,12,10,10,3,14,10,11,15,6
11,7,13,5,14,9,5,12,3,6,10,10,10,10,10,10,10,10
10,11,7,5,13,5,5,4,11,12,10,10,10,9,14,10,10,10
10,10,11,7,5,5,7,5,13,7,15,14,10,3,12,8,8,10
11,14,8,9,5,5,15,5,5,14,8,10,9,14,2,2,3,12
10,10,2,1,7,5,13,5,5,15,5,15,6,11,14,10,11,4
10,11,13,5,13,4,2,1,5,12,3,12,10,10,10,11,13,6
9,13,5,7,6,2,11,5,5,5,13,6,10,10,11,14,2,10
3,5,5,12,9,14,11,7,5,5,5,12,11,14,10,8,11,12
11,5,5,4,1,14,10,11,5,4,3,4,10,11,14,2,10,2
9,5,5,5,5,13,12,9,5,5,13,5,12,8,8,9,13,12
