18
1,5,6,1,7,5,5,5,7,5,7,6,2,3,4,2,1,6
2,1,15,7,13,6,3,5,15,5,12,9,13,13,7,13,7,14
9,5,14,8,3,15,14,3,15,5,6,2,3,6,10,2,10,10
1,5,15,5,15,14,10,10,11,4,10,10,10,10,10,11,12,10
1,7,13,4,10,10,10,10,9,6,10,11,12,10,10,11,6,10
2,11,7,6,10,11,14,10,3,15,15,13,6,9,13,12,11,14
9,12,10,8,10,10,11,15,14,10,11,7,14,3,5,7,12,8
3,6,11,7,12,8,8,8,8,8,10,10,10,10,2,10,2,2
10,11,13,15,5,5,5,5,7,6,10,10,10,10,11,14,11,14
10,10,1,13,7,5,5,4,9,12,10,9,15,14,10,9,12,10
10,9,7,5,15,6,3,5,5,5,13,6,11,15,12,1,7,12
10,1,13,6,8,9,14,1,5,7,5,12,8,10,3,7,14,2
10,3,5,13,5,4,10,3,7,15,5,5,7,13,12,10,11,14
11,13,5,5,5,6,11,14,10,10,2,3,15,7,6,10,10,10
10,3,6,3,5,15,14,10,11,15,14,10,8,10,8,10,10,10
10,8,11,12,1,12,10,8,10,10,8,10,2,10,3,12,8,10
10,2,11,5,5,4,9,5,14,11,4,11,12,10,10,3,5,12
9,13,13,5,5,5,5,4,8,9,5,13,4,9,13,13,5,4
