18
1,5,7,5,5,6,3,5,5,5,7,5,7,7,5,7,5,4
3,7,13,5,4,11,13,5,7,5,13,4,10,8,1,15,5,4
10,9,5,5,5,15,5,7,15,4,2,3,13,5,5,15,5,4
10,3,5,5,5,13,6,10,10,2,11,15,5,7,5,13,6,2
9,15,5,5,5,7,12,10,11,14,10,8,1,13,5,6,11,14
1,14,1,5,7,13,4,11,14,11,15,4,3,7,7,14,10,10
2,10,2,3,15,5,7,12,8,8,11,4,8,8,8,8,10,8
9,14,11,14,10,3,13,4,1,5,15,4,3,5,6,2,11,4
3,15,14,10,11,14,3,4,3,6,11,5,14,3,14,9,13,6
8,8,10,8,10,10,9,6,9,14,9,6,10,8,11,5,5,12
1,7,13,5,14,9,5,13,7,13,7,14,10,1,13,5,7,4
1,15,7,6,8,3,5,5,13,6,10,8,10,1,5,5,15,4
3,12,8,11,5,15,6,2,3,14,11,7,15,5,5,5,13,6
9,7,6,10,2,10,10,10,10,11,14,10,11,5,5,7,5,12
3,12,11,14,10,10,11,14,10,10,10,10,9,6,3,14,2,2
10,2,10,10,10,10,10,9,14,8,10,10,1,14,8,11,14,10
11,14,10,11,15,15,14,2,11,5,12,11,5,13,5,14,8,10
8,9,12,8,8,8,9,13,13,5,5,13,5,5,5,13,5,12
