18
1,5,5,5,6,2,2,2,1,6,2,3,4,2,1,5,7,6
3,5,5,5,13,14,10,10,2,10,11,13,6,11,5,7,15,14
9,5,5,5,6,11,14,11,14,11,14,3,13,12,1,12,10,10
1,7,5,6,11,12,10,10,11,14,11,13,5,5,7,4,10,10
2,11,4,9,12,3,13,12,8,8,11,5,5,6,10,2,10,10
11,13,5,5,5,13,5,4,1,5,13,6,3,15,14,11,14,8
11,5,5,5,7,5,4,2,3,6,2,10,10,10,10,11,15,6
10,2,2,3,15,5,7,15,12,11,14,10,10,10,11,12,8,8
9,15,14,10,11,6,10,10,3,14,10,11,14,11,14,1,6,2
3,14,10,10,11,15,14,10,9,12,9,14,8,8,10,3,15,12
8,11,14,10,10,10,10,9,5,7,5,15,5,4,10,10,11,6
2,10,11,14,10,10,10,3,5,12,3,13,5,4,10,10,8,10
11,14,10,10,10,10,10,10,3,5,13,5,5,7,14,10,3,12
8,8,8,11,12,10,11,14,11,4,3,5,5,12,10,10,9,6
3,4,2,11,4,10,10,10,9,5,15,5,5,5,13,14,3,12
9,7,14,9,7,13,12,11,5,7,12,2,3,6,3,14,9,6
3,12,9,5,13,5,6,10,3,13,5,15,14,10,8,10,1,14
9,5,5,5,5,5,13,13,13,5,4,8,8,9,5,13,5,12
