18
1,5,7,5,5,4,3,5,5,5,7,5,7,5,4,2,1,6
1,5,15,5,7,5,13,5,5,5,13,7,13,5,6,11,7,12
3,5,13,5,13,7,5,5,7,5,7,13,4,1,13,12,11,4
9,5,5,5,7,13,7,5,12,1,13,5,7,7,6,3,14,2
1,5,5,6,11,4,9,5,6,3,5,7,12,8,9,14,10,10
1,5,6,11,15,4,3,7,14,9,5,13,5,5,5,14,8,10
3,7,13,12,9,4,10,10,11,6,2,3,5,5,5,15,5,14
9,13,5,5,7,6,10,11,12,9,14,11,5,5,5,13,6,10
3,5,7,5,15,13,13,14,3,6,10,11,7,5,5,5,13,14
9,6,10,3,13,5,6,10,9,13,14,11,15,4,3,7,4,10
3,12,10,10,3,5,12,9,5,7,13,14,9,6,10,9,7,12
10,2,10,10,9,7,5,5,5,13,5,14,3,14,11,6,11,4
11,15,15,14,1,13,7,4,3,5,6,10,10,11,12,8,11,6
8,10,8,8,1,5,13,7,14,1,14,10,10,11,5,4,10,10
1,13,7,5,5,5,5,12,11,7,12,10,11,15,5,4,10,10
2,1,15,5,5,7,5,5,12,9,7,15,14,11,7,5,14,10
11,7,15,4,1,13,5,7,4,3,12,8,8,8,9,5,14,10
8,9,13,5,5,5,5,13,4,9,5,5,5,5,5,5,13,12
