20
1,5,5,5,7,5,5,5,5,7,5,5,6,1,5,5,7,6,2,2
2,1,5,7,14,1,5,6,2,11,5,6,10,1,6,2,11,14,10,10
11,7,5,14,9,5,5,14,10,11,6,10,10,1,13,15,12,10,10,10
10,10,3,15,5,5,5,12,11,14,8,8,11,6,2,10,2,11,15,14
10,8,10,10,2,3,7,5,14,11,5,4,8,9,15,13,12,10,10,10
11,4,11,15,14,10,9,4,10,9,7,7,5,5,13,5,6,10,11,14
11,7,14,10,8,10,1,7,13,5,13,15,7,5,5,5,12,10,11,14
11,14,10,11,5,13,5,13,5,5,7,12,10,2,2,3,6,11,14,10
10,10,10,10,3,5,5,4,3,7,13,7,14,11,13,14,9,12,10,10
10,11,13,13,15,5,5,4,10,11,6,10,11,14,1,13,7,4,11,14
10,11,7,5,13,5,5,5,12,9,12,10,10,10,1,5,15,5,14,10
10,9,15,5,5,5,6,3,5,5,5,12,10,11,6,1,15,4,10,8
9,7,15,6,3,5,13,13,7,5,6,1,15,14,11,5,13,6,9,6
1,14,10,10,11,5,5,5,13,6,10,2,10,11,14,1,7,13,5,12
3,14,10,10,9,6,3,4,3,14,11,13,14,8,11,6,11,6,3,6
10,10,10,10,3,13,13,5,14,8,10,1,15,4,10,10,10,11,14,10
10,10,10,10,10,2,3,6,10,2,11,7,15,6,10,11,14,10,10,10
10,11,13,14,10,10,10,9,12,10,10,10,8,9,15,14,10,10,10,10
8,10,3,12,10,10,9,5,6,11,12,9,5,6,8,8,8,10,8,10
1,12,9,5,13,13,5,5,13,13,5,5,5,13,4,1,5,13,4,8
