20
1,6,2,1,5,5,5,6,2,2,3,5,5,7,7,5,5,5,5,6
3,14,11,7,5,7,5,12,10,11,14,3,7,13,13,5,4,3,5,14
10,10,10,10,1,13,5,4,10,10,11,12,9,5,5,7,5,13,6,10
8,9,14,10,2,3,4,2,10,10,10,3,7,7,6,10,2,3,14,10
1,7,12,10,10,11,6,11,15,12,10,10,11,14,11,15,14,10,10,10
3,13,5,13,13,12,9,15,13,6,10,8,10,10,10,10,11,12,9,14
11,4,1,7,6,2,2,11,6,10,10,1,14,11,14,8,9,5,6,8
10,3,6,10,11,14,10,8,10,10,9,7,12,10,11,4,3,7,13,4
10,10,11,14,10,10,11,7,13,13,5,15,4,10,11,5,12,9,7,4
11,12,8,10,10,11,14,10,2,3,6,11,5,13,13,7,4,3,15,6
11,7,4,10,10,10,10,10,10,11,12,10,2,3,7,14,3,14,8,10
10,11,4,9,15,13,12,10,11,15,6,11,15,14,11,14,10,11,6,8
11,13,6,3,13,5,5,12,10,10,9,12,8,8,10,10,10,10,11,6
10,2,11,15,5,6,3,5,15,13,5,5,5,7,14,10,11,14,10,10
10,10,10,10,2,11,13,7,13,5,4,2,2,11,14,11,12,10,10,10
10,11,12,11,12,9,5,13,5,7,5,14,10,10,10,8,3,12,10,10
11,13,4,9,7,5,5,5,6,11,6,10,11,14,9,5,13,5,14,10
11,5,5,5,13,7,5,7,14,10,10,11,14,10,1,7,5,7,13,14
11,4,3,5,5,13,4,10,9,12,8,10,9,13,5,12,1,15,4,10
9,5,13,5,5,5,5,13,5,5,5,13,5,5,5,5,5,13,4,8
