20
1,6,1,5,5,7,5,6,2,3,5,7,5,5,5,5,5,5,7,6
3,15,7,5,7,12,3,12,11,13,7,15,7,5,5,5,5,7,14,10
10,8,10,3,13,4,9,7,12,3,12,10,11,4,3,6,3,12,10,10
11,6,10,10,1,7,4,11,6,9,6,10,9,5,14,10,11,4,10,10
10,11,15,15,7,13,5,12,8,1,15,14,3,5,14,9,13,4,10,10
10,10,10,10,10,2,1,7,4,2,10,10,11,5,13,5,5,6,11,14
10,10,8,11,13,13,5,13,7,13,12,10,11,7,5,5,7,13,13,14
10,9,5,13,7,5,7,5,13,7,5,12,10,10,2,1,13,7,4,10
10,3,5,6,10,3,15,5,5,13,7,7,12,10,10,2,3,15,4,10
11,13,6,11,13,12,9,5,4,3,14,11,6,10,10,9,14,9,5,14
10,1,14,9,5,5,7,5,4,9,12,10,10,9,14,3,13,5,4,10
10,1,15,5,5,5,14,3,5,5,5,14,9,7,13,13,5,7,4,8
10,1,13,5,5,6,10,11,5,7,5,13,5,14,1,6,2,11,7,4
11,5,5,5,5,15,15,13,5,13,7,7,4,9,5,15,13,12,11,4
11,5,7,6,2,10,10,3,5,6,10,11,4,3,5,13,5,7,13,6
10,2,10,10,11,14,9,14,1,14,10,9,6,10,3,7,7,14,2,10
10,10,10,9,14,8,1,12,1,14,10,3,12,11,14,10,10,10,10,10
11,14,9,5,13,7,5,4,3,12,10,9,6,10,10,10,10,10,10,10
8,10,2,2,3,15,7,4,9,6,11,6,10,10,10,10,10,11,14,10
1,13,13,13,12,8,9,5,5,12,8,9,13,12,8,8,8,8,9,12
