20
1,6,2,3,5,5,5,7,5,5,5,4,3,5,5,4,3,7,7,6
3,15,14,11,7,5,5,15,5,5,5,4,9,7,5,5,14,10,8,8
10,8,8,10,11,5,7,13,5,5,7,5,5,13,6,2,10,10,2,2
11,6,2,10,9,6,9,5,7,6,9,7,7,6,10,10,10,10,11,12
10,11,15,12,1,13,5,6,10,10,3,12,8,10,10,10,10,11,15,4
10,10,11,6,1,5,5,12,10,11,13,6,1,12,10,10,9,12,11,4
10,11,15,15,5,5,7,6,11,14,1,13,5,7,13,15,5,5,13,6
10,10,8,8,3,5,12,10,10,10,3,6,2,10,2,9,7,5,5,12
11,14,3,7,13,5,4,8,10,9,12,10,10,10,10,2,10,1,6,2
11,14,10,10,3,7,7,4,10,3,6,10,10,10,11,15,13,7,13,12
10,11,12,10,10,10,9,7,14,11,12,11,14,10,10,10,1,13,5,4
10,9,7,13,12,9,7,14,11,12,3,12,9,13,13,15,5,5,7,6
10,1,15,5,5,4,8,9,13,7,12,1,7,5,7,13,5,4,8,10
11,6,9,5,6,2,3,5,5,13,4,1,15,4,11,5,5,5,5,14
10,10,2,3,15,14,11,7,7,7,6,3,13,4,9,5,5,7,5,12
10,11,15,14,10,10,11,14,11,14,10,11,5,7,7,5,5,13,5,6
10,8,10,10,10,10,10,10,10,10,11,14,2,10,11,5,5,5,7,12
10,1,14,10,10,9,14,11,14,10,10,11,14,9,14,3,7,5,13,4
11,6,10,11,13,5,14,10,10,11,14,8,8,1,13,14,9,7,5,4
8,9,12,8,1,5,12,8,8,8,8,1,5,5,5,13,5,13,5,4
