20
1,7,5,7,5,5,5,5,5,7,5,5,7,5,6,3,7,6,2,2
2,11,5,13,5,6,2,3,5,13,5,7,12,2,10,10,8,11,15,14
9,14,3,4,3,12,10,10,1,6,2,11,4,11,15,14,2,10,8,10
2,10,9,7,13,4,10,10,1,15,14,11,4,8,8,9,14,11,6,10
11,14,3,13,6,2,10,10,3,12,10,11,5,5,7,5,13,12,8,8
10,11,15,4,9,15,13,13,15,4,8,10,3,5,13,7,5,5,7,6
10,10,9,6,2,11,5,6,10,2,2,10,10,3,5,13,7,5,13,12
11,14,3,12,10,9,6,9,15,13,13,14,10,11,7,5,13,7,5,4
10,10,9,4,11,7,14,3,15,5,4,10,11,14,11,5,5,15,5,4
10,10,3,6,10,10,11,14,10,3,6,11,14,10,11,5,5,15,5,4
10,11,14,9,12,10,10,10,10,11,12,9,14,10,10,3,5,13,5,6
10,10,11,5,7,15,14,10,11,13,7,5,13,12,11,15,5,5,4,8
11,14,8,1,14,10,10,11,13,6,11,5,5,4,10,10,2,3,5,6
10,10,2,3,14,10,8,8,3,14,9,5,5,4,10,9,13,12,1,14
10,9,13,14,10,9,5,7,14,11,7,5,7,5,12,1,5,7,6,10
10,1,7,14,10,3,5,12,10,8,9,7,14,3,5,5,5,12,8,10
10,3,12,8,11,15,6,3,13,6,1,14,9,15,5,5,5,7,5,14
10,11,4,2,8,8,11,12,1,15,7,12,1,12,3,5,5,13,5,14
11,13,5,13,5,7,13,6,1,14,9,7,5,6,11,5,5,5,5,14
9,5,5,4,1,13,4,8,1,12,1,13,4,9,13,5,5,5,5,12
