20
1,5,5,5,5,7,5,4,2,2,1,5,5,6,2,2,1,5,7,4
1,5,5,7,5,13,7,5,15,15,5,5,5,12,10,10,2,3,15,6
2,2,3,13,7,7,13,5,13,13,5,5,5,5,15,14,11,12,10,10
11,13,12,1,14,10,3,7,6,2,3,7,7,5,12,11,15,4,11,14
11,6,2,1,13,14,10,10,10,10,10,10,9,5,7,12,11,4,10,10
8,9,14,2,3,14,10,10,10,10,10,10,3,5,15,5,13,4,10,10
1,5,14,11,14,10,11,14,10,11,14,10,11,6,11,5,5,5,12,8
2,2,11,12,10,9,14,11,15,14,8,8,8,9,13,5,5,7,5,4
10,11,13,5,15,5,12,10,11,13,5,5,5,7,5,5,5,15,5,6
9,13,5,7,13,5,7,13,13,7,6,1,5,15,5,5,5,12,3,12
2,3,5,12,1,7,13,5,4,9,12,1,5,13,5,7,5,5,13,6
10,11,7,6,1,14,3,7,7,6,3,5,5,7,5,13,5,7,5,12
10,10,10,10,2,10,10,10,10,11,14,3,4,10,2,3,5,13,5,6
11,14,10,11,15,14,10,8,8,10,8,9,7,12,10,10,1,5,5,14
10,11,14,10,10,11,15,7,5,15,4,1,13,7,12,10,1,7,7,14
10,10,11,14,10,10,10,10,2,11,6,3,5,13,4,10,3,14,10,10
11,14,10,10,11,15,12,11,13,14,9,13,5,5,7,12,8,8,10,10
10,10,9,14,10,10,2,10,3,12,2,1,7,5,13,5,6,3,15,14
10,9,5,13,14,10,10,10,11,5,12,1,13,5,7,4,11,14,10,10
9,5,5,4,8,9,13,12,9,5,5,5,5,5,13,4,8,8,8,8
