20
1,7,6,2,2,3,6,3,5,6,2,3,5,5,5,7,5,6,3,4
2,10,10,11,15,12,11,12,1,13,14,11,5,7,5,13,4,11,13,4
10,10,10,10,11,7,13,7,5,6,10,11,5,13,5,5,5,15,5,4
10,10,11,14,10,11,4,10,2,10,11,13,5,5,7,5,5,15,5,4
11,14,10,11,14,9,7,14,10,10,10,2,3,4,11,5,5,15,5,4
10,9,13,14,10,3,12,10,11,15,14,9,13,5,15,5,5,14,2,2
11,7,4,8,9,13,6,10,8,10,8,1,5,6,11,5,5,15,13,12
10,11,4,1,5,5,14,9,7,14,3,6,2,10,11,5,5,13,7,4
10,9,6,3,5,5,13,5,14,9,12,11,14,11,15,6,1,5,15,4
11,7,12,11,5,5,7,7,12,3,6,10,11,14,10,10,2,3,15,6
10,11,7,12,3,6,8,11,6,11,12,10,10,8,11,14,10,10,10,10
8,10,11,5,12,8,1,14,10,10,2,10,9,6,10,10,10,10,10,10
3,15,13,5,7,4,3,14,10,10,10,11,7,12,8,11,15,14,10,10
10,10,3,5,13,5,14,8,9,15,15,13,13,7,4,11,14,10,11,14
10,10,11,5,5,4,11,4,3,14,9,6,3,13,7,13,13,13,14,10
11,14,11,5,5,5,14,3,12,8,1,14,9,7,15,7,7,4,10,10
10,11,13,5,7,4,10,10,2,2,3,13,7,12,10,8,9,5,15,14
10,10,2,3,15,6,10,10,11,14,10,3,14,3,15,5,5,4,8,10
10,10,9,12,8,10,10,10,10,10,10,10,11,14,9,5,5,7,7,14
8,8,1,5,5,12,9,13,12,9,13,12,8,8,1,5,5,12,8,8
