20
1,7,5,5,5,7,5,6,3,7,7,7,6,3,6,2,3,5,5,6
1,15,5,5,5,13,5,15,12,10,10,10,10,10,9,14,9,5,6,10
3,13,5,5,7,5,6,11,6,11,14,10,11,15,7,12,3,7,14,10
11,5,5,5,15,4,9,12,10,10,11,14,10,10,11,4,10,10,11,14
11,5,6,1,15,5,5,5,14,10,10,10,10,10,9,7,14,10,10,10
9,6,10,2,11,7,6,3,13,12,8,9,12,8,1,15,15,14,10,10
1,14,9,15,14,11,14,11,4,3,4,3,5,5,7,13,12,10,11,14
3,14,3,12,10,10,10,10,2,11,4,9,4,3,13,5,4,8,8,10
10,10,10,2,10,10,10,9,15,13,7,6,2,11,5,5,5,7,5,12
10,11,15,14,10,10,11,5,14,3,14,9,13,13,6,2,3,13,5,4
10,10,11,12,9,14,9,7,12,9,12,1,5,7,14,10,11,5,5,4
10,10,10,2,2,11,7,13,7,5,5,5,5,14,11,13,13,5,7,4
11,14,10,10,10,10,10,1,13,7,7,7,7,15,13,7,5,5,13,4
9,14,10,9,13,14,10,2,2,10,10,10,10,10,1,13,7,7,5,6
3,13,14,1,5,12,9,14,10,11,12,10,10,11,7,5,15,14,1,14
10,2,9,6,1,7,4,10,10,10,2,10,10,10,10,1,14,10,1,14
9,14,1,15,5,13,4,11,14,10,9,14,10,10,9,7,12,10,3,14
2,11,6,11,5,5,7,12,9,12,1,13,13,15,6,11,4,11,12,10
11,12,11,14,3,7,13,5,7,5,5,6,2,11,14,11,4,10,1,14
9,4,8,8,8,9,5,5,13,5,5,13,13,12,8,9,5,12,1,12
