20
1,7,5,7,5,5,5,7,5,7,5,5,5,5,7,5,5,6,2,2
3,15,5,13,5,6,2,10,3,13,7,5,5,6,11,6,3,14,11,14
10,10,3,5,5,15,12,8,10,2,11,7,5,14,10,9,12,9,14,8
10,10,10,3,7,13,7,5,12,10,10,10,2,11,15,7,7,7,14,2
11,14,10,11,14,1,13,7,5,14,10,11,14,8,10,10,10,10,9,12
10,10,10,10,10,1,7,13,4,10,10,10,10,3,14,11,14,9,7,4
10,10,10,10,10,3,13,5,4,9,12,8,8,10,9,14,11,6,11,6
10,10,11,14,10,11,7,7,7,7,6,1,5,15,6,10,10,10,10,10
10,9,14,8,11,12,10,10,10,8,9,7,4,10,10,8,8,9,14,8
11,5,13,7,12,1,14,10,10,3,6,11,7,12,11,5,5,7,15,6
11,7,7,13,6,1,12,10,10,11,12,10,10,3,15,4,1,14,8,8
10,10,11,4,10,3,5,12,11,12,2,10,11,14,10,3,6,11,5,6
10,10,11,4,11,13,5,5,13,7,14,10,10,8,9,12,10,10,3,12
10,10,11,7,14,3,5,5,5,14,9,15,13,5,7,6,9,12,9,6
9,14,8,10,11,13,7,5,5,15,4,8,1,7,12,11,5,6,2,10
2,10,2,10,9,6,10,3,5,13,5,7,5,14,2,10,1,14,10,10
10,11,14,10,1,14,11,15,5,5,5,13,7,14,10,10,3,13,15,14
11,12,9,12,1,14,10,9,7,5,7,6,10,11,14,10,11,6,10,10
11,5,5,4,1,14,10,1,13,6,8,9,13,14,11,13,12,10,8,10
9,5,5,5,5,13,12,1,5,13,5,5,5,12,9,5,5,13,5,12
