20
1,7,7,5,6,3,5,6,3,7,5,5,5,5,6,2,2,2,3,4
1,12,10,1,15,12,1,14,10,10,2,1,6,2,11,13,14,11,13,6
1,7,12,3,14,1,5,15,14,11,15,7,12,11,15,4,9,12,1,14
3,13,7,14,8,1,5,12,11,14,8,9,7,14,10,1,5,7,5,12
10,1,14,11,5,5,7,5,12,11,4,1,12,10,8,1,7,12,2,2
10,3,12,10,1,7,15,5,4,9,7,5,5,13,7,5,13,5,15,12
10,9,5,14,3,12,9,5,5,6,9,7,7,5,13,5,5,5,15,6
11,5,5,14,9,5,5,7,4,10,3,12,9,5,5,7,5,5,12,8
10,3,5,14,2,3,5,13,4,9,13,5,5,5,7,13,5,7,5,4
10,9,6,9,15,14,3,5,6,3,7,5,5,5,15,6,3,14,2,2
10,1,13,7,12,9,12,1,14,9,12,1,5,5,14,10,10,11,15,14
10,1,7,13,5,5,5,5,15,5,7,4,2,3,14,9,14,8,8,8
10,1,13,7,5,7,5,5,13,4,9,7,13,12,9,5,13,7,5,4
11,5,5,13,5,13,7,5,5,5,5,13,5,6,3,7,5,15,5,4
11,6,2,3,7,5,15,5,5,5,6,3,4,11,14,10,3,15,7,4
10,11,15,14,10,1,13,5,7,4,9,13,5,14,10,10,10,10,11,6
10,10,10,10,11,5,5,5,13,6,3,5,5,12,11,14,10,10,10,10
10,8,8,9,14,3,5,7,6,10,9,7,5,4,10,11,14,10,8,10
9,6,3,5,15,12,1,12,11,14,1,13,7,7,12,8,11,15,6,10
1,13,13,5,13,5,5,4,8,9,5,5,13,13,5,4,8,8,9,12
