20
1,6,3,5,5,7,7,5,7,4,2,3,6,2,3,5,5,7,5,4
2,11,14,1,5,14,10,2,11,4,9,12,10,11,15,7,5,13,5,4
11,12,10,1,5,12,10,11,13,7,5,5,13,14,10,10,2,3,6,2
9,5,15,5,4,3,14,10,2,10,3,6,2,10,9,14,9,14,10,10
1,5,15,5,5,14,10,10,10,10,10,10,11,12,1,15,5,12,11,14
1,5,15,5,7,12,11,15,14,11,12,10,11,7,5,13,5,4,10,10
1,5,15,5,15,5,13,14,11,13,7,14,10,11,5,5,5,5,13,14
1,7,13,5,13,5,7,12,10,3,12,9,12,9,5,7,7,7,5,14
3,13,4,1,7,5,12,2,11,15,4,3,4,3,5,15,12,9,4,10
10,1,7,5,15,5,5,12,10,11,6,9,7,15,7,15,5,5,4,10
11,7,13,4,9,5,5,7,14,9,12,3,12,10,10,11,5,6,2,10
10,11,5,5,5,5,5,13,13,7,6,9,6,10,11,14,2,11,14,10
10,9,7,5,5,5,5,6,3,12,8,1,14,8,10,11,14,10,9,12
10,3,13,5,5,5,5,14,9,5,6,1,15,4,10,10,8,11,7,4
10,9,5,7,5,5,5,14,1,5,15,5,15,4,10,11,6,10,9,6
10,1,7,13,7,5,5,12,1,7,15,5,13,5,13,12,9,14,2,10
10,3,13,5,13,5,7,5,7,13,13,5,7,5,4,3,4,11,15,14
11,15,5,7,5,7,13,7,14,3,5,5,15,5,4,11,4,10,8,10
10,10,3,12,1,13,4,10,10,10,3,6,10,2,3,13,6,10,2,10
8,9,13,5,5,5,4,8,9,12,8,9,13,13,12,1,12,9,13,12
