20
1,7,7,5,5,5,5,6,2,2,2,3,5,7,5,5,4,1,5,6
1,15,13,5,6,1,7,13,12,11,13,13,5,13,7,6,2,3,5,14
1,12,1,7,13,5,13,7,5,15,7,5,6,3,15,14,11,12,3,12
1,5,7,13,4,1,5,15,4,8,9,4,9,12,10,9,12,3,15,6
3,5,13,5,4,3,5,13,7,5,5,5,5,5,15,5,4,8,8,8
9,5,5,5,6,11,5,7,14,2,2,3,6,3,13,5,5,7,5,4
1,7,5,5,14,8,1,14,8,9,14,10,11,15,5,5,5,13,7,4
3,13,4,3,13,5,5,13,7,5,15,12,9,13,7,5,5,7,15,4
11,7,6,9,7,5,5,5,14,1,13,7,5,5,13,5,7,14,11,4
10,11,14,1,13,6,3,6,10,3,6,10,2,1,6,3,14,10,9,6
10,10,11,7,5,13,12,9,14,11,12,10,10,3,14,10,10,10,1,14
10,10,10,11,5,5,5,5,14,11,4,11,14,10,11,14,10,10,1,14
10,10,11,14,3,6,3,6,10,11,4,10,9,12,8,8,10,11,6,10
11,14,10,11,14,11,14,10,11,15,6,10,3,5,7,5,12,10,10,10
10,9,14,8,8,10,10,11,14,10,9,15,14,3,15,5,4,9,13,14
10,3,15,5,6,10,10,10,8,9,6,8,11,12,10,2,3,5,7,12
10,8,10,1,12,11,14,10,3,5,13,5,15,4,9,14,10,1,13,6
10,2,10,2,2,10,11,14,9,7,4,1,13,6,3,14,10,3,5,12
10,11,14,11,14,10,10,10,3,13,7,5,5,12,10,11,14,10,2,2
9,12,9,12,9,12,9,13,13,5,13,5,5,5,12,8,8,9,13,12
