20
1,7,5,5,5,5,7,5,7,5,5,7,5,5,7,6,3,6,3,6
3,13,5,5,4,3,14,1,13,7,4,11,5,6,10,10,10,10,10,10
9,7,5,5,4,10,8,3,7,12,2,8,3,12,10,11,14,11,12,10
1,14,1,5,7,13,4,8,11,4,11,7,13,4,11,12,10,10,2,10
2,10,2,3,13,5,4,1,15,5,13,13,7,5,14,2,10,11,15,14
11,12,11,15,7,7,5,5,13,5,6,3,13,4,8,9,15,14,10,10
11,4,10,10,9,15,7,5,5,5,12,10,3,5,6,3,12,10,8,10
9,7,14,11,6,9,15,7,7,5,4,10,10,1,14,11,5,13,5,14
1,13,14,10,9,5,14,8,11,5,4,11,14,1,13,13,5,6,1,14
3,5,12,10,1,5,13,6,11,7,6,10,11,6,1,6,3,12,1,14
10,2,2,8,1,5,7,12,10,9,12,9,14,10,3,14,10,2,2,10
10,10,10,1,7,5,13,7,14,3,5,5,12,11,14,10,9,14,11,14
9,15,13,7,13,5,4,10,9,13,5,7,4,10,10,11,5,13,14,10
2,11,4,9,5,7,4,10,3,5,7,13,4,8,10,10,3,7,12,10
9,13,7,5,5,15,6,11,14,2,10,2,1,5,15,15,14,10,3,14
1,5,13,5,6,10,11,14,10,11,15,12,3,7,12,11,12,11,14,10
1,5,5,7,12,10,8,8,11,14,11,5,12,9,5,13,4,10,8,10
1,6,1,15,6,11,4,2,10,8,9,7,5,5,6,2,2,11,4,10
1,14,2,10,10,11,5,12,11,5,7,14,3,6,11,15,15,15,6,10
1,13,13,12,9,13,5,4,9,4,8,9,12,9,12,8,8,8,9,12
