20
1,6,2,3,7,5,4,1,5,7,6,3,4,1,7,5,5,4,2,2
1,14,10,10,11,5,7,5,7,12,9,13,7,5,15,5,5,5,15,14
3,12,10,10,10,1,14,3,13,5,4,2,10,1,13,7,5,4,8,10
9,7,14,10,10,3,13,15,5,7,4,9,12,3,5,13,7,6,1,14
3,14,11,14,10,9,6,9,4,11,5,5,7,13,5,5,12,11,7,12
10,9,14,11,15,7,12,3,4,10,2,3,13,5,7,6,3,14,10,2
10,3,15,12,8,9,6,9,5,13,13,15,4,3,14,11,14,10,11,14
10,8,9,7,6,2,10,3,5,5,5,13,4,10,10,8,8,10,8,8
11,7,5,14,9,13,13,15,5,5,5,7,4,10,11,5,5,13,7,4
8,9,5,13,7,7,5,13,4,3,6,11,4,10,10,3,5,5,15,4
3,5,5,5,12,9,7,5,6,9,13,13,7,14,10,8,1,5,15,4
9,5,5,7,4,3,12,1,15,5,5,5,12,9,13,5,7,5,15,4
3,5,5,13,5,15,7,5,13,5,5,5,5,5,5,6,11,6,10,2
9,5,7,5,4,9,13,5,5,5,5,5,5,7,6,11,14,10,10,10
1,7,13,5,6,3,7,5,5,5,5,6,3,15,15,12,10,9,13,14
2,9,6,2,11,14,9,5,5,5,6,9,14,10,9,6,11,5,4,10
10,1,15,14,10,8,3,5,5,5,12,3,12,10,3,14,9,5,7,14
11,6,10,10,11,5,14,1,7,5,6,9,6,8,10,9,7,5,12,10
10,10,10,11,13,6,10,2,10,2,10,3,13,4,10,1,15,5,4,10
8,9,12,8,1,12,9,13,13,12,9,13,5,5,12,1,13,5,4,8
