20
1,5,7,6,1,5,7,5,5,7,5,5,7,5,5,5,5,7,5,4
1,7,14,11,6,3,13,4,3,12,3,7,13,5,7,5,7,12,3,6
3,12,11,14,11,13,5,6,9,7,12,10,1,7,13,5,13,5,12,10
11,5,14,10,10,1,5,12,1,14,3,12,3,13,5,4,2,3,4,10
11,4,10,10,9,7,4,3,5,14,10,3,15,5,5,5,14,11,4,10
11,4,10,11,5,13,7,13,4,10,10,10,9,6,3,6,9,13,6,10
9,4,11,13,5,5,13,5,5,13,15,12,1,15,14,8,1,5,15,14
1,7,13,5,5,7,7,5,7,5,13,4,2,10,11,4,1,7,13,12
1,15,4,3,5,13,14,3,13,5,7,6,10,10,10,3,7,13,7,4
2,9,6,9,7,6,10,9,6,3,14,11,15,14,11,14,10,2,11,6
10,2,10,1,14,10,10,3,12,9,12,10,10,10,10,8,8,9,12,10
11,13,12,1,14,10,11,13,7,7,5,12,8,9,13,5,5,6,3,14
9,5,7,6,10,8,8,1,14,9,5,6,3,5,6,3,4,11,14,10
1,5,15,13,13,7,5,5,13,6,1,15,12,1,13,15,5,12,10,10
3,6,10,2,2,9,7,5,4,11,7,15,4,3,6,9,5,4,8,10
11,15,14,11,13,5,13,7,4,10,8,9,7,12,8,2,1,5,5,14
10,10,10,9,5,7,6,11,6,10,1,5,13,5,7,13,5,5,5,14
10,8,11,5,5,12,9,12,8,10,1,5,5,5,15,5,5,5,7,12
10,1,13,5,7,4,2,2,2,9,5,5,5,7,14,1,5,5,13,6
8,1,5,5,13,5,13,13,13,5,5,5,5,13,12,1,5,5,5,12
