20
1,7,5,5,5,5,6,2,3,5,6,3,5,7,5,5,5,6,3,6
2,9,7,5,5,7,13,15,14,1,15,14,3,13,5,5,7,12,8,10
10,3,12,2,2,10,2,11,14,2,10,11,13,4,1,7,13,5,7,12
11,15,6,10,10,10,10,10,10,11,12,10,3,5,6,10,2,2,11,6
8,10,9,13,13,15,14,10,10,11,5,14,9,6,9,13,15,12,8,10
2,10,1,7,4,10,10,10,11,13,6,8,1,13,7,5,13,5,5,12
10,10,2,10,2,10,10,8,11,4,11,6,3,5,13,7,5,7,5,4
10,10,9,13,14,10,10,1,13,6,10,10,8,1,5,15,5,13,7,6
10,9,5,7,13,12,10,2,3,13,12,11,7,7,5,13,5,5,14,10
9,5,7,13,5,6,11,14,10,3,6,10,10,11,6,2,2,3,14,10
3,5,13,5,5,13,13,13,14,11,12,11,14,10,11,14,11,14,10,8
9,7,5,7,5,5,5,5,15,13,5,14,11,14,10,11,14,10,11,4
1,15,5,13,7,5,5,5,15,5,5,14,10,8,10,8,10,8,9,4
1,15,4,1,13,7,5,5,15,6,3,14,10,3,12,3,13,6,2,2
3,12,2,2,3,15,4,3,12,9,12,8,11,13,5,14,1,13,14,10
11,4,10,9,12,9,6,11,7,6,3,5,13,7,5,12,3,6,11,14
9,7,14,1,5,7,12,10,10,8,9,5,5,13,7,5,14,8,10,10
1,12,10,3,5,13,7,14,11,4,2,3,5,5,13,5,14,2,10,10
2,3,15,15,4,2,10,10,9,7,14,11,5,5,5,5,14,10,11,12
9,12,8,9,5,12,8,8,1,12,9,13,5,5,5,5,13,13,13,4
