20
1,5,7,7,5,5,5,5,7,5,7,5,5,5,5,7,5,7,7,4
2,3,14,9,5,7,5,5,13,6,9,5,5,7,5,12,3,14,11,4
10,10,11,7,5,15,5,5,5,15,7,6,1,13,7,6,10,8,9,6
11,12,11,14,2,10,3,7,7,14,10,10,3,4,10,11,14,1,5,14
11,7,14,10,10,10,10,10,10,10,9,14,9,5,14,10,10,3,7,12
10,10,10,11,14,10,8,10,10,9,6,11,6,2,10,10,10,10,11,4
10,10,10,10,10,11,6,10,11,5,14,10,9,13,14,9,13,14,9,6
10,9,12,8,9,12,9,14,10,3,14,9,5,6,10,2,3,14,3,14
10,1,6,3,7,5,6,11,14,8,9,7,6,10,10,11,14,10,10,10
9,7,13,12,9,4,10,10,10,3,6,11,13,15,15,14,10,11,14,10
3,15,5,5,5,7,12,10,10,9,13,14,1,12,8,10,8,10,10,10
10,10,3,5,5,15,5,13,14,3,7,14,3,5,5,12,2,11,14,10
10,11,15,7,5,13,5,5,15,14,10,10,9,5,7,5,13,12,11,14
10,10,10,11,6,2,3,7,14,10,10,10,1,5,13,7,5,7,14,10
10,10,10,10,10,11,14,10,8,10,8,9,5,6,2,10,2,10,10,10
10,10,11,14,11,14,10,9,7,12,1,5,7,12,10,11,14,10,10,10
11,15,12,8,8,8,10,1,13,7,7,7,15,6,11,14,9,14,8,10
11,14,3,7,6,2,10,3,5,12,8,8,10,11,12,9,4,10,3,14
10,11,14,10,10,10,11,13,5,5,6,2,11,13,7,5,4,11,14,10
8,8,8,8,9,13,12,1,5,5,13,13,12,1,13,5,4,8,8,8
