20
1,6,2,2,1,5,5,6,2,3,5,5,5,7,5,5,5,5,7,4
3,15,13,15,5,5,5,13,15,13,7,7,5,13,4,3,5,5,13,4
11,14,2,11,5,5,5,5,14,1,14,9,7,5,4,11,5,6,1,6
10,11,12,11,5,7,5,5,13,6,11,7,13,5,7,13,4,10,3,14
10,11,4,10,2,10,2,2,3,15,14,10,1,5,14,2,2,10,10,10
10,11,7,14,10,10,10,10,10,10,10,11,5,7,12,10,11,15,14,10
8,8,8,11,14,11,14,10,10,10,10,10,1,13,6,10,10,10,10,10
1,5,7,12,9,12,11,13,12,10,11,14,1,5,13,13,14,10,10,10
3,6,10,1,5,5,15,7,5,12,10,10,3,6,2,2,11,14,11,14
10,9,14,1,7,5,15,13,4,3,14,10,10,9,12,9,14,8,11,14
10,3,12,3,15,6,9,5,6,9,12,10,11,5,5,7,13,5,14,10
10,11,5,14,8,8,1,5,14,3,4,11,14,2,3,12,2,2,10,10
10,10,2,10,3,6,3,5,12,9,6,10,10,10,11,7,13,13,14,10
10,10,10,10,8,11,14,1,6,3,12,11,14,11,14,11,4,2,10,10
10,11,12,11,7,12,9,5,15,13,5,12,9,12,10,11,7,14,11,12
10,10,3,14,10,1,7,4,11,5,4,1,5,7,12,10,10,10,10,2
11,14,10,10,10,3,14,2,11,7,5,7,5,13,5,14,11,14,10,10
10,9,13,13,14,10,11,14,10,8,3,15,5,7,6,11,14,11,14,10
10,1,5,7,12,10,10,11,15,5,14,9,4,8,9,14,10,11,12,10
8,1,5,13,5,12,8,8,9,5,13,5,5,5,5,12,8,9,5,12
