20
1,6,2,3,7,5,5,7,5,5,6,3,5,5,5,7,5,5,7,6
3,14,11,14,9,5,5,15,7,4,11,13,5,5,7,13,5,4,8,8
10,10,10,10,3,5,7,12,9,5,13,5,6,1,13,7,5,5,5,4
10,10,10,10,9,5,13,6,3,5,5,5,14,1,5,13,5,5,5,6
10,10,10,10,1,5,5,14,10,2,3,5,13,5,5,6,3,7,5,14
10,11,12,11,5,7,5,15,14,10,10,1,5,7,7,13,14,11,4,10
10,11,6,11,4,8,1,12,11,12,11,5,5,12,11,4,10,9,6,8
10,10,10,10,2,3,7,5,14,3,14,2,3,5,15,6,10,3,13,6
11,14,9,13,12,10,10,3,15,12,9,13,12,1,14,11,14,11,4,10
10,9,7,5,4,10,11,14,10,3,7,6,3,5,12,8,11,13,4,10
8,1,13,5,7,14,10,11,14,9,12,9,13,5,7,5,15,5,5,12
3,5,5,7,13,12,10,10,11,7,5,5,7,5,13,7,13,7,7,6
10,3,5,15,5,5,12,10,10,10,2,1,13,7,4,11,4,10,10,10
10,9,7,14,1,5,6,10,8,11,14,3,5,13,7,15,6,10,10,10
10,1,14,10,3,5,15,12,1,12,10,10,3,5,12,8,8,10,10,10
9,5,14,8,9,5,13,6,3,5,12,11,15,5,5,5,4,10,10,10
2,3,14,3,5,7,5,13,13,7,5,14,9,7,5,6,2,10,10,10
10,10,11,12,1,13,5,4,1,15,4,10,1,15,4,11,14,9,13,14
11,14,11,5,5,5,5,7,5,15,4,8,1,13,6,10,10,3,5,12
8,8,9,5,5,5,5,13,5,13,5,5,5,5,12,8,9,13,5,4
