20
1,7,5,5,5,5,5,7,4,1,7,6,2,3,7,7,4,3,6,2
3,13,5,7,5,5,5,13,5,7,12,11,14,10,8,9,5,12,9,14
10,3,7,14,3,6,1,6,3,15,4,10,11,15,7,7,5,6,2,10
10,8,8,9,14,9,7,13,12,9,4,10,8,8,8,8,3,15,14,10
10,3,7,7,15,5,13,5,5,5,7,13,5,7,5,4,10,10,11,14
10,11,15,14,10,3,4,1,5,5,14,1,5,15,5,5,14,10,10,10
10,10,10,10,10,9,7,7,5,5,12,1,7,15,5,6,11,14,10,10
11,14,10,10,10,1,14,11,6,3,5,7,13,13,4,10,10,9,14,10
10,8,10,10,11,7,14,10,9,13,5,13,7,5,5,15,12,1,14,10
10,3,14,9,14,8,8,9,6,3,7,7,13,5,4,10,1,5,13,14
9,12,10,1,13,5,6,3,14,9,12,11,5,5,4,10,1,7,5,12
3,5,12,3,7,7,13,14,9,5,4,9,5,5,7,15,5,12,2,2
9,7,4,11,14,10,1,15,5,5,5,7,7,5,12,9,5,7,13,12
1,15,4,10,10,10,3,13,5,7,4,11,14,3,5,7,4,9,7,6
3,14,2,10,11,14,11,4,2,10,2,10,11,14,1,13,7,7,12,8
10,9,15,14,10,10,11,4,11,13,14,10,10,10,1,5,14,11,5,4
11,7,12,10,8,9,13,4,10,1,15,14,11,15,6,3,14,9,5,6
10,11,4,9,7,5,5,5,14,2,10,8,10,10,11,12,8,1,5,14
10,9,5,7,12,3,5,5,13,13,12,1,12,10,11,7,5,5,5,12
8,1,5,13,5,13,5,5,5,5,5,5,5,13,13,13,5,5,5,4
