12
1,5,5,7,5,5,5,7,7,5,5,4
2,1,5,14,2,1,5,15,15,5,5,4
11,7,5,13,14,3,7,15,13,5,5,6
10,11,5,6,10,10,10,10,3,7,6,10
10,10,1,14,11,12,8,11,14,11,15,14
10,10,3,12,11,7,6,10,10,10,11,14
11,12,10,2,10,9,12,10,10,10,10,10
11,4,11,15,15,7,5,12,8,8,10,10
9,6,8,10,11,13,5,7,5,4,10,10
1,15,7,12,10,3,5,15,5,5,12,10
3,14,9,4,9,13,7,13,5,5,7,12
8,9,5,5,5,5,13,5,5,5,13,4
