12
1,5,7,5,5,7,5,5,6,2,3,6
3,5,13,5,5,15,5,4,10,10,10,8
10,2,1,7,7,13,5,4,10,11,15,6
11,15,7,13,13,5,5,4,11,14,10,10
10,8,11,7,5,7,5,7,14,10,11,14
10,2,10,11,4,11,6,10,11,13,14,10
10,9,15,15,6,9,12,11,14,1,14,10
10,3,12,10,11,5,7,12,10,1,12,8
10,9,6,10,11,6,9,6,11,5,5,4
8,1,14,8,10,10,1,13,13,7,5,6
1,7,13,5,14,10,3,7,5,13,5,12
1,13,5,4,8,9,13,13,5,5,5,4
