12
1,7,7,5,5,5,5,7,5,7,5,4
2,10,11,5,5,5,4,10,1,15,5,4
10,10,11,6,2,2,2,10,1,15,4,2
10,10,10,9,13,13,13,14,3,13,6,10
11,12,9,5,5,5,5,14,10,1,13,14
9,7,5,5,4,3,7,13,14,3,4,10
3,15,7,5,4,9,12,3,15,15,4,10
10,10,10,3,6,1,5,14,10,11,7,14
10,11,15,12,9,7,5,12,8,8,8,10
11,14,9,7,6,9,7,5,5,7,6,10
10,10,1,14,8,1,13,7,4,10,11,14
8,8,1,13,5,5,5,13,4,8,8,8
