12
1,5,5,7,5,5,6,3,7,7,6,2
2,2,3,13,5,5,13,12,8,10,9,14
10,11,13,5,7,5,4,1,7,15,7,14
10,11,5,5,15,5,4,3,15,14,10,10
10,11,7,6,11,5,5,14,10,10,10,10
11,14,8,11,14,3,6,10,10,8,8,10
10,11,4,10,10,9,13,14,10,3,5,14
8,11,4,8,10,2,1,14,11,15,6,10
3,13,4,2,10,10,3,13,12,8,10,8
9,7,4,10,10,10,11,6,2,3,14,2
3,14,2,11,12,11,14,11,14,10,10,10
8,9,13,13,5,12,8,8,9,12,9,12
