12
1,7,5,7,4,3,6,3,5,7,5,4
1,15,4,9,5,14,10,10,3,13,6,2
3,13,5,7,5,12,9,12,11,7,14,10
9,5,7,13,5,5,7,4,11,14,11,14
3,5,13,5,7,5,13,6,10,10,8,10
10,3,7,6,10,3,6,10,10,10,3,14
10,10,10,8,10,9,13,15,14,10,8,8
11,14,11,4,11,5,6,10,10,10,1,6
10,10,11,4,8,1,15,14,9,13,7,12
10,11,14,2,2,3,15,13,5,6,9,4
10,10,9,15,14,10,9,5,5,13,5,6
9,12,1,12,9,13,5,5,5,5,5,12
