12
1,7,7,5,5,5,5,5,7,5,5,4
1,13,15,5,5,5,6,3,14,2,3,6
2,3,15,6,2,1,14,10,11,15,12,10
11,14,10,10,9,5,15,14,10,10,3,14
8,10,8,10,3,5,12,11,14,10,10,10
1,13,6,11,14,3,6,10,10,10,10,10
3,5,12,10,10,11,12,8,8,9,14,10
10,2,2,10,11,14,2,1,5,6,11,14
9,13,15,12,10,11,14,1,5,13,14,10
3,5,13,4,10,10,11,7,5,5,13,12
11,5,5,5,14,10,11,13,5,5,7,4
9,5,5,5,12,8,9,5,5,5,13,4
