12
1,7,7,6,2,3,7,5,5,5,5,6
3,12,10,11,15,14,11,5,5,5,5,12
11,6,10,8,10,10,11,5,5,5,7,4
10,10,11,4,10,10,11,5,5,5,13,6
10,10,11,6,10,9,13,5,7,5,5,12
10,11,15,14,10,3,6,1,13,5,5,6
10,10,10,10,10,11,12,3,7,5,7,14
8,9,14,10,9,14,1,14,10,3,12,8
3,7,14,10,3,14,1,14,10,11,5,4
8,8,8,11,14,8,3,14,10,11,5,6
2,1,5,13,15,5,12,11,14,10,2,10
9,5,5,5,13,4,1,12,9,12,9,12
