12
1,7,5,5,5,5,4,3,7,5,5,6
3,15,7,5,5,5,5,15,15,5,6,8
10,11,13,5,5,7,4,10,11,6,11,6
10,9,5,5,7,13,4,10,10,10,10,10
10,1,6,3,15,5,6,10,10,10,10,10
10,3,13,14,10,3,14,10,10,11,12,10
8,9,4,10,8,9,12,10,10,11,6,10
3,6,3,15,6,2,2,11,14,10,11,14
10,9,14,10,9,13,13,12,10,10,10,10
8,3,13,13,5,5,7,4,11,14,10,10
3,13,6,3,4,2,10,3,14,10,10,10
9,4,9,13,5,13,13,12,8,9,13,12
