12
1,5,6,1,7,4,1,5,5,5,7,4
1,5,14,1,15,5,5,5,5,7,14,2
1,5,14,3,13,7,7,5,5,13,13,14
2,3,15,15,6,9,13,7,5,5,6,10
11,12,8,8,9,5,7,13,5,5,14,10
11,7,7,4,2,3,14,3,7,5,14,10
11,14,9,5,14,9,12,10,11,4,11,14
10,10,3,7,13,5,5,12,9,6,10,10
10,11,13,13,6,3,6,2,1,12,10,8
10,10,1,5,15,14,10,10,3,5,13,4
10,10,3,5,12,8,9,15,15,5,6,2
8,8,9,5,5,5,5,13,12,1,13,12
