12
1,5,7,5,5,7,5,5,4,1,5,6
3,4,11,6,3,13,5,7,5,5,7,14
9,5,14,10,11,7,7,13,5,5,14,8
3,7,13,15,14,10,11,5,5,5,12,2
8,11,4,10,10,8,9,6,3,7,5,14
3,15,6,10,11,7,6,10,8,11,4,10
10,8,8,9,14,9,12,11,7,13,4,8
10,3,6,2,11,5,4,10,9,5,7,4
10,10,10,10,11,4,3,14,1,5,15,4
11,14,10,11,15,6,10,10,1,5,15,4
10,10,11,12,8,11,12,11,5,5,13,6
8,8,8,1,5,13,4,8,1,5,5,12
