12
1,7,5,5,7,5,5,7,5,5,5,4
3,13,5,5,15,6,3,13,5,7,5,4
9,5,5,6,8,11,14,3,5,15,7,6
3,5,5,15,7,14,11,15,6,10,10,10
10,3,6,10,8,8,10,8,10,10,10,10
9,14,9,13,6,3,14,1,14,10,10,10
3,13,6,1,14,9,12,1,14,8,10,10
10,2,10,1,15,5,4,3,13,5,13,12
10,10,10,1,13,5,6,9,5,5,5,6
11,15,14,2,1,5,14,2,2,2,3,14
10,10,10,10,1,7,15,13,13,13,14,8
8,8,9,13,5,12,8,1,5,5,13,4
