12
1,7,5,5,5,5,5,5,5,7,7,6
3,12,2,1,6,2,3,5,5,15,14,10
9,7,14,3,15,14,10,1,7,12,10,10
1,12,11,12,10,11,14,1,13,6,10,10
2,1,15,4,10,8,8,1,5,14,10,10
9,5,13,6,11,7,6,3,6,10,9,14
3,7,6,11,14,9,12,10,11,13,7,12
10,8,9,12,9,6,3,14,8,1,13,4
9,5,5,7,6,10,11,13,5,5,5,6
1,5,5,14,11,15,15,5,5,5,7,12
3,7,5,12,10,10,10,2,3,7,14,2
8,9,5,4,8,8,9,13,12,8,9,12
