12
1,5,5,5,5,7,7,5,5,5,7,4
3,5,7,5,6,9,15,5,7,5,13,4
11,5,15,4,11,7,12,1,15,7,6,2
9,6,9,6,10,9,7,5,12,8,11,12
1,14,3,13,14,1,12,1,7,5,13,4
3,14,11,6,10,3,6,2,10,2,2,2
10,8,8,8,10,9,13,15,15,14,9,14
10,3,6,3,14,3,6,10,10,10,1,14
11,14,9,12,9,12,11,14,10,10,3,14
10,10,1,5,5,7,13,14,10,9,12,10
10,10,3,5,7,13,5,13,14,3,5,14
8,8,9,5,13,5,5,4,8,9,4,8
