12
1,7,5,7,5,4,3,5,4,2,2,2
3,12,1,13,5,5,15,5,5,14,11,14
10,3,5,5,5,7,13,5,4,9,14,10
10,10,3,7,5,13,5,5,7,5,13,12
11,14,10,11,5,5,5,7,15,5,5,6
10,11,15,14,3,7,6,10,10,3,5,12
10,10,10,10,10,9,12,11,14,10,2,2
10,10,10,11,14,2,3,14,11,15,14,10
11,15,12,8,8,11,14,10,10,10,11,14
10,11,5,5,4,10,10,10,10,10,10,10
10,9,7,5,4,10,10,10,10,8,8,10
8,1,13,5,5,12,8,8,9,5,5,12
