12
1,7,5,5,5,7,5,5,5,5,7,4
1,15,5,5,4,9,7,7,5,5,13,4
1,13,5,7,4,2,11,13,6,3,5,6
2,3,5,13,6,11,12,1,13,14,1,12
11,13,7,5,15,13,5,5,5,13,7,4
8,3,13,4,10,3,6,1,5,7,13,4
3,13,5,6,11,13,12,2,2,9,7,4
11,4,3,12,11,4,2,10,10,1,13,6
9,6,11,4,9,4,11,14,10,1,5,14
1,15,14,2,2,3,14,9,15,5,5,12
3,14,9,15,13,14,9,7,13,7,5,6
8,8,1,13,4,8,1,13,4,9,4,8
