12
1,7,5,7,5,5,4,1,7,4,3,6
3,13,5,13,5,7,5,7,13,4,10,10
9,7,4,2,3,13,4,9,5,6,10,10
1,15,5,13,15,5,4,3,5,13,12,10
3,12,3,6,11,5,4,11,7,6,3,14
9,7,12,9,14,3,6,10,11,14,8,10
3,14,1,7,12,9,14,10,10,11,7,14
10,10,1,13,7,5,12,10,10,10,8,10
10,9,5,5,15,5,5,12,10,10,2,10
11,5,7,5,13,5,5,5,14,11,15,14
10,1,15,4,2,2,3,6,10,10,10,10
8,1,13,5,13,13,12,9,13,12,8,8
