12
1,5,5,7,4,2,3,5,5,5,5,6
1,5,5,15,6,11,15,7,5,5,5,12
3,7,5,15,14,10,11,13,7,6,1,6
10,11,6,10,11,14,10,2,10,10,3,12
10,10,10,10,10,8,8,9,14,11,15,4
10,10,8,10,10,3,6,1,12,8,11,4
10,11,6,10,11,13,12,2,3,6,10,2
10,8,10,11,14,1,5,15,14,11,14,10
11,5,13,12,10,3,5,12,8,10,9,12
10,1,5,5,12,11,7,5,5,13,5,6
11,5,7,5,6,10,10,2,2,3,7,14
9,4,8,1,13,13,13,13,13,12,8,8
