12
1,7,5,4,2,2,2,3,7,7,6,2
3,13,5,5,14,11,15,14,8,10,9,12
10,3,5,6,10,10,8,10,2,10,3,6
11,15,5,12,9,14,3,13,14,10,10,10
8,10,2,3,7,12,11,6,9,15,15,14
3,12,9,12,10,3,14,10,1,14,8,10
9,6,3,5,12,9,12,10,2,10,2,10
3,12,9,5,7,5,7,15,15,14,10,10
9,7,5,5,12,3,14,8,8,11,12,8
2,11,5,5,4,10,10,3,6,10,2,2
10,9,5,6,3,14,10,10,11,14,11,12
9,5,5,13,12,8,9,12,8,9,13,4
