12
1,6,2,2,1,5,7,5,5,5,5,6
2,10,11,14,1,7,13,4,1,5,5,14
10,10,10,11,7,15,7,4,3,6,2,10
11,15,14,10,8,8,9,7,12,11,13,12
8,8,8,10,1,5,7,13,7,14,3,6
3,5,5,13,6,3,14,3,12,11,14,10
9,5,5,6,8,9,12,9,6,10,8,10
1,5,5,15,5,7,5,5,12,11,4,10
3,5,5,13,7,15,4,1,6,11,4,10
9,7,5,5,13,15,5,7,13,13,5,14
1,15,5,5,4,10,3,13,5,5,5,14
1,13,5,5,5,13,13,5,5,5,5,12
