12
1,7,5,5,7,5,5,5,5,5,5,6
1,15,5,7,15,7,6,2,1,6,1,14
3,15,4,8,8,8,11,14,1,14,3,14
11,14,3,5,5,5,14,10,3,13,14,8
10,8,9,7,5,4,8,8,11,4,9,4
9,5,5,13,6,3,6,2,10,2,1,6
1,6,3,4,10,9,14,10,10,11,7,14
3,13,15,5,13,5,15,12,11,14,10,10
11,5,15,7,5,4,9,5,12,11,14,10
11,4,8,9,5,6,2,2,2,10,10,10
11,5,5,5,7,12,9,15,15,15,14,10
9,5,5,5,13,5,5,12,8,8,9,12
