12
1,5,7,5,4,3,7,7,5,5,5,4
1,7,13,5,4,10,9,14,1,6,1,6
1,13,5,7,6,10,1,15,5,13,5,12
1,7,5,12,11,14,3,13,5,7,5,4
1,15,6,2,10,8,11,7,4,9,5,6
3,14,11,14,10,3,14,11,5,5,5,14
10,8,10,8,10,9,12,9,4,3,5,12
11,6,9,7,15,5,5,7,6,10,2,2
10,11,5,13,13,7,4,8,11,13,13,12
10,10,1,5,5,13,5,5,15,5,7,4
9,13,5,7,5,7,5,5,15,5,15,4
1,5,5,13,5,13,4,1,12,1,13,4
