12
1,6,2,2,1,6,3,5,7,5,5,4
1,15,13,13,5,14,10,2,11,5,5,6
2,11,5,5,5,14,10,10,10,1,5,14
9,14,3,5,5,13,14,10,10,3,7,12
3,12,10,1,7,4,9,14,11,14,11,4
11,4,9,5,12,3,7,15,12,10,10,2
9,7,5,5,6,9,12,11,6,10,9,14
1,15,5,4,9,7,7,14,11,12,1,14
1,13,5,6,1,14,10,10,9,5,7,12
3,5,4,11,6,10,8,10,2,2,10,2
11,5,5,12,10,10,2,10,11,13,15,12
9,5,5,4,9,12,9,12,8,1,13,4
