12
1,7,7,7,5,5,5,5,7,5,5,4
2,10,11,13,7,5,5,7,13,5,5,4
9,12,8,3,13,5,5,15,7,4,2,2
2,1,7,13,5,5,6,10,10,3,14,10
11,7,12,3,5,5,12,8,9,12,11,12
8,9,5,15,5,7,6,1,5,5,15,4
3,7,7,14,2,9,12,3,7,7,14,2
10,10,10,10,10,2,2,10,10,10,9,14
10,11,14,10,10,11,15,14,10,10,1,14
11,14,10,10,10,10,10,11,15,15,5,14
10,10,10,11,15,14,10,10,10,10,3,12
8,8,9,13,12,8,8,8,8,8,9,4
