12
1,7,6,3,6,3,5,5,5,7,6,2
2,10,10,10,10,10,1,7,5,12,10,10
10,10,11,14,9,12,1,15,5,4,11,14
11,12,8,11,5,5,5,13,5,6,10,10
9,5,5,15,5,5,5,7,5,15,14,10
1,7,6,11,6,3,6,11,6,11,14,10
3,12,11,14,10,9,13,12,10,10,10,10
11,4,10,10,9,7,5,5,12,10,11,14
10,3,14,11,5,13,7,5,4,10,10,10
10,10,10,11,5,7,15,7,7,12,10,8
11,14,11,15,4,8,8,8,11,5,13,6
8,9,12,9,5,5,5,5,13,5,5,12
