12
1,5,7,5,5,5,7,6,1,7,4,2
1,5,13,6,1,5,12,10,1,15,4,10
3,5,7,12,2,2,2,10,1,14,3,14
10,1,13,6,11,15,15,15,7,13,14,10
11,7,5,12,10,8,10,10,11,4,8,10
10,11,7,6,10,3,14,10,9,5,6,10
10,11,15,15,14,9,12,9,7,5,12,8
10,10,10,10,10,1,7,5,13,5,5,6
10,10,10,10,11,7,13,5,7,5,5,12
10,10,10,10,10,11,5,5,13,7,5,6
11,14,11,15,14,10,3,5,5,13,7,12
8,9,12,8,8,9,13,5,5,5,13,4
