12
1,7,5,6,2,2,3,5,7,5,5,4
2,11,4,8,10,10,11,5,13,5,5,6
9,13,5,5,13,15,14,3,5,5,5,12
3,5,5,6,2,10,10,11,5,5,7,4
9,6,2,10,11,12,8,10,3,5,13,6
1,13,14,9,14,3,6,10,10,3,7,14
1,7,13,5,14,9,14,10,10,10,10,10
2,9,6,1,13,7,13,13,14,10,10,8
11,5,14,1,5,15,5,4,11,14,11,4
8,1,13,5,7,14,3,5,14,8,10,2
3,6,1,7,13,12,10,1,15,5,15,14
8,9,5,13,5,5,12,1,13,5,12,8
