12
1,5,5,7,4,3,5,5,7,5,5,4
3,5,5,15,6,11,5,7,13,5,5,6
11,4,1,12,9,15,5,13,5,5,6,10
10,2,2,3,5,13,7,5,5,6,10,10
10,10,10,11,5,5,15,6,2,10,10,10
10,10,11,14,2,3,14,11,14,10,10,10
10,11,14,11,14,9,12,10,10,11,15,14
11,14,10,8,9,7,5,12,11,14,10,10
9,14,11,7,5,13,7,5,12,8,10,10
1,14,10,10,2,3,14,1,7,7,12,10
3,12,10,11,13,14,9,5,12,9,7,14
9,4,8,9,5,13,5,5,4,1,12,8
