12
1,7,7,5,5,6,3,6,2,3,7,4
1,12,10,1,5,15,14,11,14,10,11,6
3,7,12,2,2,10,10,8,11,15,12,10
10,11,5,13,13,14,9,4,8,8,3,12
10,9,7,5,5,15,5,6,3,6,11,4
10,2,11,7,6,11,6,9,12,10,11,6
10,10,10,8,10,9,12,1,7,13,12,8
10,11,14,3,13,5,5,6,10,3,6,2
8,8,10,11,5,5,4,10,10,8,9,14
3,5,13,13,7,5,6,10,10,3,7,12
9,7,5,5,13,7,12,9,14,10,11,6
1,13,5,5,5,13,5,5,13,12,8,8
