12
1,7,7,5,5,5,5,7,5,5,7,6
2,10,11,5,5,5,5,13,7,4,10,10
10,10,9,5,5,5,7,5,15,4,10,8
10,11,7,5,5,5,13,5,15,5,15,4
10,10,10,1,7,5,4,3,13,6,11,4
9,14,10,3,12,3,6,11,4,8,9,4
1,15,15,15,5,13,12,11,5,5,5,4
3,14,10,9,5,6,3,12,2,2,2,2
8,8,10,1,5,12,10,3,15,14,10,10
1,7,13,4,3,4,10,10,10,10,10,10
3,13,7,5,13,4,9,12,8,10,11,14
9,5,13,5,5,5,5,5,5,13,12,8
