12
1,5,7,7,6,2,3,5,5,5,7,4
3,6,10,10,11,14,11,5,7,5,13,4
8,11,13,14,8,11,14,2,11,5,6,2
3,14,2,11,7,14,9,13,13,6,9,14
10,10,10,10,10,8,3,5,7,13,6,10
8,9,12,8,10,3,14,3,12,2,10,10
2,3,6,3,14,9,12,10,3,14,11,14
11,13,14,10,11,5,4,9,14,8,8,8
11,4,11,12,11,5,5,7,15,4,3,6
10,2,11,4,9,7,4,8,9,5,14,8
11,14,9,7,7,15,6,3,5,5,12,2
8,8,1,12,8,8,8,9,5,5,5,12
