12
1,5,5,5,7,5,7,5,5,7,5,6
1,7,5,5,12,1,13,5,5,13,6,10
3,13,5,5,5,7,6,2,2,3,14,10
11,5,5,5,4,10,9,15,13,12,8,10
11,5,5,5,5,13,5,13,6,3,7,14
9,5,5,7,5,7,6,2,10,8,10,10
3,6,3,14,2,9,12,11,15,7,14,10
10,9,14,11,14,2,2,10,10,10,10,10
10,2,11,15,14,10,10,10,10,11,14,10
10,10,10,10,11,14,11,14,10,10,11,14
11,13,14,10,10,10,10,11,15,14,10,10
8,1,12,8,8,9,12,8,8,8,8,8
