12
1,7,4,1,5,5,7,5,5,7,5,4
1,13,6,3,5,5,13,7,5,13,5,6
3,4,10,10,2,1,5,15,5,5,7,12
10,3,15,15,13,7,5,13,4,3,15,6
9,12,8,11,5,13,5,6,2,10,10,10
3,5,5,14,2,3,7,15,14,11,14,10
11,7,7,15,14,9,12,8,8,10,10,10
10,10,10,8,11,5,5,5,7,14,10,10
10,10,10,3,14,3,7,6,10,11,15,14
11,14,10,10,10,10,8,11,14,10,10,10
10,10,10,10,11,13,6,10,10,10,9,14
8,9,13,12,8,1,12,8,8,8,1,12
