12
1,7,5,5,5,5,7,5,5,7,7,6
1,13,7,6,3,4,9,6,1,12,10,10
1,7,12,9,13,7,5,13,6,2,10,10
1,13,6,2,2,11,7,4,11,13,14,10
2,3,14,10,11,14,9,5,13,6,11,14
9,14,11,15,14,11,6,2,2,10,10,10
3,12,8,8,8,9,12,10,10,10,10,10
10,2,1,5,7,5,5,15,15,15,14,10
10,11,6,3,12,1,7,12,10,8,9,14
10,10,9,13,7,5,13,4,9,4,1,14
9,14,1,7,13,6,2,1,7,7,4,10
1,12,1,13,4,9,13,5,12,9,5,12
