12
1,6,2,3,6,1,5,5,5,7,7,4
3,12,10,10,9,5,5,5,5,14,9,6
11,5,13,13,7,5,7,4,3,12,3,12
11,7,7,5,15,7,13,6,11,4,11,6
10,10,10,2,10,8,1,15,15,6,10,10
10,10,10,11,12,3,6,10,10,11,14,10
8,10,10,9,6,9,13,12,10,9,14,10
3,12,11,5,14,3,6,2,10,2,10,10
11,5,14,1,13,12,9,15,13,14,10,10
11,6,9,7,5,7,5,12,1,12,11,14
8,10,3,13,5,13,7,5,7,4,10,10
1,12,9,5,5,5,13,5,13,5,13,12
