12
1,5,5,5,5,7,5,5,6,2,2,2
2,3,5,7,5,13,5,7,13,13,12,10
11,15,4,11,7,5,5,15,5,5,7,14
10,9,7,14,10,2,3,13,5,5,14,8
8,1,12,10,9,15,13,7,6,1,14,2
1,5,7,13,4,11,6,8,9,7,15,14
3,6,11,7,6,9,12,1,5,14,10,10
10,11,14,10,11,6,1,7,5,12,10,10
10,10,10,10,8,11,7,15,4,3,15,14
11,14,10,11,7,12,8,9,5,14,10,10
10,10,10,10,9,6,3,5,5,12,10,8
8,9,13,12,1,12,9,5,5,5,13,4
