12
1,6,2,1,5,7,4,1,5,7,5,4
2,10,11,5,7,13,4,1,5,15,5,4
11,15,12,1,13,5,6,1,5,13,7,4
9,13,5,6,3,7,15,5,5,7,13,4
1,5,7,13,12,8,9,6,2,10,3,6
3,4,11,6,2,3,6,11,15,15,12,10
11,7,14,10,10,9,13,14,10,11,5,14
10,10,10,11,14,1,6,10,10,10,1,14
10,10,8,8,11,5,15,15,15,14,3,12
10,11,5,4,8,1,14,8,8,10,9,6
11,13,5,6,1,5,15,5,4,9,5,14
8,1,5,13,5,5,13,5,5,5,5,12
