12
1,5,5,6,3,5,7,5,5,7,5,4
2,3,7,13,15,4,9,5,5,13,5,4
11,15,13,5,13,5,7,6,2,3,7,6
10,10,1,7,5,5,13,15,13,12,8,8
10,10,3,13,5,7,5,14,3,7,6,2
10,10,9,6,2,11,6,9,12,11,15,12
11,14,2,11,14,9,12,2,3,14,11,6
10,10,11,12,10,3,6,11,14,10,10,10
10,11,13,6,10,10,11,14,10,10,10,10
10,10,2,10,11,14,10,10,8,8,8,10
10,10,11,14,10,10,10,10,3,4,3,12
9,12,8,9,12,8,8,9,13,5,13,4
