12
1,5,7,7,6,3,7,5,5,7,5,4
1,5,12,10,9,14,9,7,7,15,7,6
1,5,5,14,2,10,1,12,8,8,8,10
3,7,7,13,12,9,7,5,6,2,3,12
10,8,9,5,7,5,13,7,12,11,13,6
11,7,7,6,10,3,6,9,7,14,1,14
10,10,9,15,14,11,12,3,12,11,6,10
10,11,4,10,10,9,6,10,2,10,10,10
8,11,4,10,10,3,13,15,12,10,11,14
2,10,3,14,10,11,4,11,5,14,10,10
9,15,14,11,15,13,4,9,6,10,11,14
1,12,8,8,8,1,5,5,12,8,8,8
