12
1,6,2,3,7,5,7,5,5,4,2,2
2,11,15,14,9,5,13,7,5,5,14,10
11,14,10,11,7,5,5,13,5,6,9,14
10,8,10,9,13,5,5,7,7,12,1,12
9,6,10,1,7,5,5,13,15,5,7,4
1,13,14,1,12,3,6,3,13,6,10,2
3,7,13,5,7,13,12,9,6,11,13,12
10,10,1,6,11,5,7,6,11,14,2,2
10,10,3,13,14,1,12,9,14,10,9,14
10,11,15,7,13,7,7,4,10,10,3,12
10,10,10,10,1,12,9,5,14,8,11,6
9,12,8,9,5,5,5,5,13,5,12,8
