12
1,6,2,2,2,3,6,1,7,5,5,6
2,10,10,11,15,14,10,1,13,7,4,10
10,11,15,14,10,10,11,5,5,13,6,10
10,10,10,10,10,10,8,1,5,5,14,10
9,12,8,10,11,13,7,5,7,5,12,8
2,3,6,10,10,3,14,3,13,5,5,4
9,12,11,14,10,9,12,9,7,6,2,2
2,2,10,10,9,6,2,1,14,10,10,10
10,10,10,11,6,11,15,7,15,14,11,14
11,15,15,14,11,12,8,8,8,11,12,10
10,10,10,9,15,5,7,6,2,11,4,8
8,8,8,1,13,4,8,9,12,9,5,4
