12
1,7,7,7,7,7,5,5,4,3,5,4
3,14,8,10,8,9,5,7,5,13,5,4
10,10,3,13,5,7,5,13,7,5,5,6
10,11,14,3,5,15,5,5,13,7,6,10
10,10,10,11,5,13,7,6,2,10,11,14
10,10,9,13,6,3,14,10,10,10,8,10
11,15,4,1,14,9,12,11,14,9,6,10
10,11,4,1,13,7,5,12,11,7,12,10
9,13,7,5,5,13,7,5,12,10,2,10
2,3,13,5,5,5,13,7,5,12,10,10
9,15,5,7,5,4,2,9,6,2,10,10
1,12,1,13,5,5,13,5,13,13,13,12
