12
1,6,2,2,2,3,5,5,7,5,5,6
3,13,15,13,12,11,5,7,13,5,5,12
11,6,9,5,7,13,5,15,5,5,7,4
10,9,7,7,13,5,5,12,3,7,15,4
10,2,10,11,5,5,5,6,10,10,9,6
10,11,14,10,2,3,6,11,14,10,1,14
11,14,11,14,11,13,12,10,10,10,2,10
10,10,10,10,11,6,1,14,10,10,11,12
10,10,10,9,14,9,5,12,9,15,13,4
10,11,13,6,9,7,4,1,6,11,7,4
11,15,5,13,7,13,4,3,13,12,9,6
8,9,5,5,13,5,5,13,5,4,1,12
