12
1,7,6,3,7,5,5,5,7,5,5,4
2,10,11,14,10,3,7,5,13,7,5,4
10,10,10,10,10,10,10,1,5,15,5,4
10,10,11,15,14,10,10,3,7,14,3,4
11,14,10,10,11,12,9,12,10,11,15,4
11,14,10,10,10,3,6,3,12,10,11,4
10,10,11,14,10,9,13,15,7,15,14,2
10,11,14,11,14,1,5,14,10,10,11,14
10,11,14,10,10,3,7,14,10,10,10,10
10,10,10,8,8,10,8,10,8,10,8,8
11,12,11,6,3,14,1,13,6,10,3,6
9,4,8,9,12,9,5,4,9,13,12,8
