12
1,6,1,7,7,6,2,2,1,5,6,2
3,15,7,14,10,8,11,14,1,5,14,10
10,8,8,10,11,5,14,10,3,7,14,10
11,5,7,15,13,6,10,11,14,8,8,10
10,1,14,10,3,12,8,8,9,7,5,12
10,3,12,10,10,3,6,1,5,13,6,2
10,9,6,11,15,13,12,1,5,7,12,10
10,1,13,12,9,7,7,7,5,13,4,10
9,5,5,5,7,15,12,9,5,7,5,14
1,7,4,3,14,11,5,5,7,13,4,10
2,9,6,8,9,13,7,5,13,5,5,14
9,5,13,5,5,5,13,5,5,5,5,12
