12
1,5,5,7,4,1,7,7,7,7,5,4
1,7,4,11,6,1,12,10,8,9,5,4
3,13,5,14,10,3,7,15,6,3,7,6
9,7,4,10,10,8,8,8,9,14,10,10
3,13,6,10,11,5,5,5,5,13,12,10
8,3,12,10,11,7,6,1,5,7,7,14
3,13,4,8,8,9,12,1,5,15,14,10
10,2,2,3,5,5,5,5,5,14,8,10
10,10,10,9,6,1,5,5,5,14,2,10
10,10,10,2,11,5,7,5,5,12,10,10
11,14,10,10,10,1,15,7,5,6,10,10
8,9,13,13,13,5,12,8,1,13,13,12
