12
1,7,5,5,5,5,6,1,6,1,7,4
1,13,5,5,7,6,11,7,14,3,15,6
1,5,5,7,13,13,12,10,10,10,10,10
1,7,5,14,2,3,6,10,11,12,11,14
1,15,4,9,15,12,10,11,14,1,14,10
1,15,4,3,12,3,14,10,10,3,12,10
2,10,2,11,6,9,12,10,8,9,4,8
10,10,10,8,9,5,7,13,5,7,6,2
10,11,14,1,6,1,13,5,7,12,9,12
11,12,11,5,14,1,5,7,13,4,3,4
10,3,14,2,11,7,5,13,5,7,13,6
8,8,8,9,12,9,5,5,5,13,5,12
