12
1,7,5,7,5,5,5,5,5,7,5,4
3,13,5,13,5,7,5,6,2,9,5,6
11,5,5,5,5,13,5,15,13,5,5,12
10,3,7,6,2,2,2,9,7,6,3,6
11,14,8,11,13,13,13,7,12,11,14,10
10,10,1,13,4,3,7,13,6,8,8,8
10,10,2,3,6,9,12,3,13,4,3,6
10,11,14,10,9,7,5,13,5,5,14,10
10,10,10,10,2,9,7,7,5,7,14,10
11,12,9,15,15,5,12,10,2,10,10,10
8,3,5,12,9,5,4,10,11,12,11,14
1,13,5,4,1,5,5,12,9,4,8,8
