12
1,6,2,2,2,2,2,3,5,5,5,4
3,15,14,9,14,11,12,9,5,5,7,6
8,8,11,5,15,15,5,5,5,5,12,10
2,3,12,3,12,9,4,3,6,3,7,14
9,15,5,13,5,5,4,10,9,12,8,8
3,13,6,3,7,7,6,10,1,7,5,6
10,1,15,14,10,9,12,11,5,15,4,8
10,2,10,10,10,2,3,14,1,15,5,4
10,11,15,14,10,9,12,10,1,15,5,4
11,14,10,10,10,1,5,14,3,15,5,6
10,10,10,10,10,1,5,14,10,10,1,14
8,8,8,8,9,5,5,13,12,8,1,12
