12
1,5,5,7,6,3,5,4,2,3,6,2
3,5,5,12,10,9,5,6,11,14,11,14
11,4,3,5,12,1,7,12,8,8,8,10
9,6,11,4,3,7,12,2,3,5,7,14
2,10,9,7,14,9,5,14,9,6,8,10
11,14,3,14,10,3,6,9,5,15,4,10
8,9,12,8,10,11,12,2,2,10,2,10
2,3,6,3,15,14,3,14,10,11,14,10
10,10,8,10,8,9,12,11,13,12,8,10
11,13,6,10,1,5,5,15,5,5,7,14
10,3,14,10,1,5,5,13,7,5,13,14
8,8,9,12,1,5,5,5,13,5,5,12
