12
1,7,5,5,5,5,7,5,5,5,5,6
1,13,7,7,5,5,13,5,5,7,4,10
1,7,13,15,6,1,5,7,7,14,2,10
1,13,7,14,11,5,7,12,10,10,10,10
1,5,14,10,10,1,13,6,10,10,11,14
3,7,14,11,15,7,6,11,15,15,14,10
10,11,14,10,10,9,12,10,10,8,9,14
10,10,11,14,11,5,5,12,8,1,5,14
10,10,8,10,11,5,6,2,2,2,2,10
10,10,3,12,8,1,13,15,13,14,11,14
9,14,11,4,2,3,5,15,4,9,12,10
1,13,13,5,13,13,5,13,5,5,5,12
