12
1,6,3,5,5,7,5,5,7,5,5,4
1,13,14,2,1,13,5,7,15,5,5,4
2,2,10,11,7,5,5,13,15,5,7,6
10,10,10,10,10,2,3,6,10,1,14,8
11,13,12,10,11,13,14,9,13,7,13,4
9,5,7,12,8,3,14,3,7,13,6,2
1,7,13,7,6,9,12,10,11,5,15,14
3,14,3,14,10,2,1,14,11,4,10,10
10,8,10,10,10,10,3,12,10,2,10,10
10,2,10,11,14,10,10,2,11,12,10,10
9,15,12,10,10,10,11,15,13,4,8,8
1,13,4,8,9,13,13,13,5,5,5,4
