12
1,6,3,5,5,5,7,5,6,1,6,2
3,15,13,7,5,5,13,6,10,1,15,14
10,9,5,13,5,7,7,13,15,5,12,8
9,7,4,3,7,13,14,3,13,5,5,4
2,10,2,10,11,4,9,14,2,3,5,6
11,14,10,10,10,3,6,9,15,13,4,10
10,11,15,14,10,9,14,1,15,6,2,10
10,11,14,8,11,5,13,5,14,11,14,10
11,14,10,2,10,2,1,7,12,11,14,10
10,10,10,11,13,13,5,13,6,10,11,14
10,10,11,15,5,5,5,5,15,14,10,10
8,8,8,9,5,5,5,5,12,8,8,8
