12
1,6,1,7,4,3,5,7,5,5,5,6
1,15,5,13,5,15,7,13,5,5,6,10
2,11,5,5,5,14,9,5,7,4,10,10
11,15,5,7,5,15,7,6,11,6,10,10
10,9,5,14,3,12,8,9,12,11,15,14
11,5,4,10,11,7,6,3,5,12,10,10
11,5,4,10,10,9,12,11,7,6,10,10
9,7,4,10,9,5,7,12,8,11,14,10
3,13,6,10,3,5,13,5,7,12,8,10
10,1,13,14,9,6,1,5,13,7,5,12
10,3,4,11,5,13,7,5,5,13,7,4
9,13,4,9,5,5,13,5,5,5,13,4
