12
1,7,5,5,7,5,5,5,5,7,4,2
3,15,7,5,13,5,5,7,5,13,6,10
10,10,11,6,1,5,5,15,4,3,13,14
10,10,10,10,1,5,5,15,4,9,6,10
10,11,14,11,7,5,5,14,3,6,10,10
11,14,10,10,10,3,6,9,14,10,11,14
10,10,10,10,10,11,12,1,14,9,14,10
10,11,12,11,13,15,7,6,11,5,14,10
11,15,5,15,4,8,8,11,12,2,10,10
10,11,7,15,5,5,5,13,4,11,15,14
10,10,10,11,5,5,5,5,4,10,8,8
8,8,8,9,5,5,5,5,5,13,5,4
