12
1,7,5,7,6,1,7,7,4,3,7,6
3,12,3,12,10,3,14,9,5,12,10,8
11,6,10,2,10,10,10,2,1,7,13,4
10,10,11,14,11,12,10,11,5,13,7,4
11,14,10,11,14,1,12,10,3,5,13,4
10,11,14,10,10,3,6,10,9,5,5,4
10,10,8,10,10,9,13,13,5,7,5,4
10,10,3,15,14,1,7,5,7,13,5,4
9,13,14,8,10,1,15,5,13,7,5,4
2,1,15,4,9,5,15,5,5,13,5,4
10,1,13,7,5,5,14,3,5,7,5,6
9,5,5,13,5,5,13,13,4,8,1,12
