12
1,5,7,5,7,6,1,7,5,5,7,4
1,7,13,4,10,11,7,13,5,6,11,4
1,13,7,4,8,10,9,4,1,14,11,4
1,7,15,6,2,10,3,5,7,12,9,4
2,11,14,11,14,8,9,5,13,5,5,6
10,10,10,10,10,3,7,6,3,5,7,14
9,14,11,14,10,9,12,11,14,1,12,10
1,14,10,10,9,5,5,12,11,7,6,10
2,10,10,11,6,3,7,5,15,14,10,10
10,10,11,12,9,14,8,1,12,10,8,10
10,10,9,6,1,15,4,1,7,12,3,14
9,12,1,13,5,13,5,5,13,5,12,8
