12
1,7,6,2,3,4,2,3,6,3,6,2
3,14,9,12,11,5,13,12,11,12,11,12
10,9,7,4,9,6,1,7,15,4,11,6
10,1,13,6,3,14,3,12,11,7,14,10
8,3,5,13,12,8,9,6,10,8,11,14
1,13,7,7,6,3,6,10,10,2,10,10
3,5,14,8,10,9,14,11,14,10,10,10
11,7,12,1,13,7,13,12,11,12,8,8
10,11,4,3,5,13,7,5,13,7,5,4
10,10,2,11,5,5,13,7,4,10,1,6
10,10,10,11,5,5,5,14,3,13,5,14
8,9,13,13,5,5,4,9,12,1,5,12
