12
1,6,2,3,7,5,6,3,6,3,6,2
2,11,15,14,9,4,9,12,10,10,10,10
10,10,11,13,7,5,5,5,12,11,15,14
10,10,11,5,13,5,5,4,2,10,10,10
11,14,9,7,7,5,5,5,15,12,11,14
10,8,1,12,10,3,7,5,13,6,10,10
10,2,3,6,10,9,12,2,1,15,12,10
11,14,10,10,10,2,1,14,3,13,4,10
10,10,10,10,10,11,7,13,15,5,5,12
8,11,12,10,9,14,9,5,13,5,7,4
1,15,4,11,5,15,4,3,5,7,13,4
1,13,5,12,1,13,4,8,1,13,5,4
