12
1,5,7,5,4,3,4,3,7,7,4,2
2,2,10,2,3,13,5,12,10,9,6,10
10,11,15,13,13,7,5,5,15,4,10,10
11,14,10,2,2,11,7,6,9,6,11,12
8,8,9,15,15,12,8,10,2,11,14,2
1,7,5,12,10,3,6,10,10,10,11,14
2,10,2,2,10,9,13,14,10,10,10,10
11,14,11,14,11,7,6,11,15,12,10,10
10,11,14,10,8,8,9,15,13,6,8,10
10,10,10,11,7,5,5,13,5,14,3,12
10,8,10,9,13,7,5,5,5,12,11,4
9,5,13,5,5,13,5,5,5,5,13,4
