12
1,7,7,5,7,5,5,7,5,5,7,6
1,14,8,1,13,7,5,15,6,2,11,14
1,13,7,5,5,13,5,14,9,14,10,10
2,3,13,7,5,5,5,13,6,10,10,10
10,11,5,12,3,5,5,6,10,11,15,14
11,15,4,2,10,3,7,14,10,10,10,10
8,9,5,15,12,9,12,10,11,14,10,8
2,3,7,14,3,6,3,15,14,10,9,6
10,10,10,10,10,9,14,10,10,10,1,14
11,14,10,10,10,2,10,8,8,9,5,14
10,10,10,11,12,9,14,3,5,5,7,12
8,8,8,9,4,1,12,8,1,5,13,4
