12
1,7,5,5,5,7,5,5,5,5,5,6
3,13,7,4,1,13,5,7,5,4,1,14
11,7,13,6,3,6,3,14,3,4,1,14
10,9,6,10,10,11,14,11,13,7,5,14
10,3,12,11,14,8,8,8,3,12,1,14
10,11,6,10,10,3,6,1,13,6,1,14
10,10,10,10,10,9,14,1,5,13,7,12
11,12,10,10,10,2,11,7,5,5,13,4
11,6,11,15,14,10,11,13,7,5,5,4
8,10,10,8,11,14,10,1,13,7,5,6
3,13,13,6,8,9,15,5,5,13,6,8
9,5,5,13,5,4,9,5,5,5,13,4
