12
1,7,5,5,5,5,5,5,7,5,5,4
1,14,2,3,5,7,5,7,15,5,5,6
2,10,10,10,3,13,4,10,11,7,4,10
11,15,15,12,9,5,4,10,8,11,4,8
8,9,13,5,7,5,5,15,7,13,7,6
1,5,5,5,14,3,6,10,11,6,8,8
1,7,5,4,11,13,12,10,8,11,5,6
3,13,5,4,10,1,7,13,6,10,2,10
9,5,7,5,13,5,12,3,12,11,15,14
3,6,11,7,5,7,5,13,4,10,10,10
10,11,14,9,5,13,7,5,5,12,10,10
8,8,9,5,5,5,13,5,4,1,12,8
