12
1,5,6,3,6,1,5,5,6,1,7,4
2,3,12,10,11,7,5,5,13,7,13,6
11,13,4,10,10,9,5,7,5,13,7,12
11,7,4,11,14,1,5,13,7,5,13,6
8,9,7,14,10,1,7,7,13,7,5,12
1,7,12,8,8,3,14,9,4,11,5,4
3,12,3,7,6,9,12,2,2,10,3,6
9,7,12,10,11,5,5,13,13,15,13,14
3,13,4,11,14,3,5,7,5,13,4,10
11,5,4,10,10,11,7,13,5,5,4,10
10,1,7,14,10,10,9,5,5,5,6,10
9,5,12,8,9,12,1,5,5,5,12,8
