12
1,6,1,6,2,2,2,3,6,2,2,2
1,15,6,10,11,15,14,10,11,14,10,10
1,14,11,15,14,8,9,12,10,11,14,10
3,14,10,8,11,5,5,4,8,10,9,14
10,10,11,7,13,7,5,7,6,10,2,10
10,9,12,9,4,11,6,8,11,12,10,10
9,5,5,7,4,9,12,3,15,5,15,12
3,5,6,9,5,6,3,12,11,4,9,4
11,4,8,3,5,12,10,3,14,1,7,4
10,2,3,13,5,6,11,12,9,7,13,4
11,14,10,3,7,14,10,1,5,13,5,6
8,9,12,8,8,9,13,5,5,5,5,12
