12
1,7,5,6,1,6,2,2,3,5,5,4
3,12,1,13,7,13,14,11,13,5,5,6
11,5,5,5,13,6,11,14,2,3,7,14
11,7,6,2,1,14,10,8,9,12,8,10
10,10,10,10,3,12,9,5,5,7,5,12
10,10,11,13,12,3,6,1,7,13,5,4
11,14,9,5,6,9,13,5,13,7,5,4
10,10,2,3,13,5,5,5,5,15,4,2
10,10,9,13,5,5,7,7,5,13,5,12
10,9,7,5,5,7,13,13,7,7,6,2
11,4,9,6,1,14,1,7,12,10,8,10
9,4,1,12,1,12,1,13,4,9,5,12
