12
1,7,6,2,3,6,3,7,5,5,5,4
1,12,9,13,14,11,12,11,5,5,5,4
3,6,3,5,15,12,1,15,5,5,5,6
10,10,10,3,13,5,5,13,7,6,1,14
10,11,14,10,3,5,5,7,14,10,3,14
10,10,10,10,11,7,6,10,10,10,10,10
8,10,10,11,14,9,12,11,14,11,14,10
1,14,10,10,10,2,2,10,11,14,10,10
1,12,8,8,11,15,14,10,10,11,14,10
2,3,5,5,12,10,11,12,9,12,11,12
11,15,5,5,4,10,10,1,7,5,13,4
8,9,5,5,4,8,9,5,13,5,5,4
