12
1,5,7,5,5,5,5,7,5,5,5,4
1,5,15,4,2,3,7,13,5,5,7,4
1,7,15,6,11,14,8,1,5,5,13,6
1,12,8,10,10,11,5,5,5,5,7,12
1,5,7,15,15,13,5,6,3,7,13,6
1,5,14,8,8,3,6,11,14,10,2,10
1,7,14,3,6,11,12,8,10,10,10,10
3,12,10,10,10,10,2,2,11,15,14,10
11,7,14,11,14,10,10,11,12,10,11,14
8,10,11,14,10,11,14,11,4,8,10,8
1,14,10,8,10,10,11,13,5,7,13,4
1,12,9,4,9,12,9,5,5,13,5,4
