12
1,5,5,5,7,5,7,5,5,6,2,2
1,7,7,7,14,2,10,2,2,11,15,14
3,12,8,8,10,11,14,11,14,10,10,10
9,5,5,6,10,8,9,12,11,12,11,14
2,2,3,12,11,7,5,5,15,7,14,10
11,12,9,7,14,11,6,3,12,10,10,10
9,5,5,14,8,9,12,10,2,10,8,8
1,7,5,13,6,3,4,10,10,11,5,4
3,13,5,6,11,15,4,11,14,10,1,6
10,3,5,12,10,9,7,14,8,9,5,14
8,9,5,4,10,3,13,13,7,5,6,10
1,5,5,5,12,9,5,4,9,4,9,12
