12
1,7,7,5,7,4,3,5,5,5,5,6
1,14,8,1,15,4,11,5,5,5,7,12
2,11,4,1,15,5,13,5,5,5,13,6
9,15,4,2,10,3,5,7,7,5,5,12
3,13,4,10,11,12,3,12,11,5,5,4
10,3,4,10,10,3,14,3,15,5,6,2
11,13,6,11,14,9,12,10,11,6,10,10
10,1,15,12,10,2,2,10,10,10,10,10
11,7,15,6,11,14,10,10,10,10,11,14
10,10,8,10,10,9,12,10,10,10,10,10
10,10,1,14,9,7,5,15,14,10,10,10
8,8,1,13,5,13,4,9,13,13,13,12
