12
1,7,5,5,5,7,4,1,7,5,7,4
1,13,7,5,7,13,4,1,12,3,13,4
2,1,13,6,9,5,4,1,5,13,5,6
10,1,5,15,6,1,7,5,7,5,5,14
11,5,6,10,11,5,14,1,13,6,3,12
10,1,13,12,10,3,14,3,5,13,15,4
11,6,1,6,10,9,12,9,6,2,9,6
10,10,1,14,10,1,5,7,13,14,1,14
8,9,7,13,14,3,5,13,4,8,1,14
3,5,13,5,12,11,5,5,5,5,7,14
9,5,7,5,5,15,7,5,6,1,14,10
1,5,13,5,5,12,9,4,9,5,12,8
