12
1,7,6,3,5,5,6,1,5,5,5,6
3,14,11,14,1,7,12,1,7,5,5,12
10,10,10,10,3,13,4,3,15,6,3,6
10,10,11,14,11,5,5,12,8,11,12,8
10,11,14,11,15,5,5,7,7,15,7,4
8,8,10,10,10,3,6,8,10,8,9,4
3,7,14,11,14,11,12,1,13,7,5,4
10,10,11,12,10,10,3,5,7,13,5,4
11,14,11,7,14,10,11,7,14,3,4,2
10,10,10,10,10,10,10,8,9,15,5,12
10,11,14,8,11,14,11,5,5,12,2,2
8,8,9,4,8,9,13,5,5,5,13,12
