12
1,5,7,7,5,7,5,5,5,5,7,6
3,5,12,8,3,13,5,7,5,5,13,12
10,3,7,4,9,5,5,14,3,6,3,6
10,10,9,7,5,5,5,12,8,9,14,8
10,11,7,15,7,5,5,7,7,6,11,4
11,14,10,10,10,3,6,10,10,11,15,6
10,10,10,10,10,9,13,12,8,8,10,8
10,8,11,15,14,2,2,1,6,2,11,6
10,3,12,10,11,14,11,5,14,11,14,10
11,13,4,10,10,11,14,2,10,10,10,10
11,7,5,13,14,8,8,10,11,14,10,10
8,9,5,5,13,5,4,9,12,8,8,8
