12
1,7,6,2,3,6,2,1,7,5,5,4
3,14,8,11,14,10,10,3,15,5,7,4
10,10,3,14,10,10,10,10,8,3,13,4
10,10,10,10,8,11,15,14,1,15,5,4
8,9,12,11,4,8,8,10,1,15,5,4
3,4,3,15,4,3,7,15,6,11,5,4
11,6,10,11,6,9,12,10,10,11,4,2
10,11,14,8,11,5,4,9,13,13,5,14
10,10,10,3,15,5,6,1,5,7,4,10
11,14,11,14,8,1,13,5,5,15,5,14
10,11,14,10,3,6,2,1,7,13,6,10
8,8,9,13,12,9,12,1,13,4,8,8
