12
1,5,5,5,6,2,3,7,5,5,5,4
3,4,3,7,14,10,11,13,5,7,5,4
9,6,10,10,10,10,10,1,7,13,7,4
3,15,14,10,11,15,14,1,14,3,14,2
10,10,10,10,10,8,9,5,12,8,11,12
10,10,10,10,11,7,6,3,4,3,14,2
10,11,13,15,14,9,12,11,6,10,11,12
11,15,4,10,10,1,7,12,10,10,9,6
10,11,6,10,10,3,14,2,11,12,1,12
9,12,11,13,12,8,9,14,9,7,5,4
3,5,13,5,5,5,5,14,1,15,6,2
9,5,5,5,4,1,5,13,5,12,9,12
