12
1,7,7,5,5,5,7,5,5,7,5,4
3,14,10,3,5,7,13,5,5,14,2,2
8,8,11,15,5,13,7,5,4,11,15,14
2,2,10,11,5,5,15,5,4,10,10,10
11,14,10,9,7,5,13,7,6,8,8,10
11,14,10,1,14,3,7,14,10,3,5,12
10,11,14,3,14,9,12,10,10,11,4,2
10,10,11,14,10,2,3,15,14,11,6,10
8,9,14,8,8,10,8,10,10,8,10,10
1,5,13,5,7,15,7,12,9,5,13,14
3,5,7,7,14,11,13,5,4,2,3,14
8,1,12,8,8,9,5,5,5,13,12,8
