12
1,5,5,5,7,5,5,7,5,7,5,4
3,5,7,7,13,5,5,12,1,14,2,2
9,6,9,13,7,5,4,2,3,14,10,10
1,12,1,5,13,5,7,12,10,8,10,10
1,7,5,5,5,5,13,4,9,7,13,12
1,13,7,5,4,3,6,3,4,11,5,6
3,6,9,5,6,9,14,11,6,10,1,14
11,14,3,5,12,1,13,12,11,15,5,14
10,11,15,7,6,2,3,6,10,10,2,10
10,8,10,8,8,10,10,10,10,10,10,10
10,2,11,6,3,15,12,9,13,14,9,14
8,9,12,9,12,9,5,5,5,13,5,12
