12
1,7,5,5,5,6,2,2,3,7,4,2
3,14,3,7,4,11,13,13,12,11,5,12
10,11,14,9,5,13,5,5,5,13,5,6
11,15,13,5,5,7,5,5,5,5,7,12
10,10,3,5,5,13,5,7,5,4,11,4
10,10,11,4,2,3,6,11,6,2,9,6
8,8,9,5,14,11,12,10,11,14,3,12
3,4,3,5,12,10,1,12,10,10,11,4
9,6,10,3,4,10,1,5,14,11,13,6
1,15,15,13,6,11,5,7,12,11,7,14
3,12,10,3,13,14,1,13,6,10,10,10
9,4,8,9,4,8,1,5,13,12,8,8
