12
1,6,2,3,5,5,5,7,5,5,5,4
2,11,14,9,5,5,5,14,2,3,5,6
11,14,9,5,5,5,7,13,14,9,6,10
8,9,5,5,7,5,13,4,9,7,12,8
1,5,6,2,11,5,5,7,5,13,5,4
1,6,10,11,12,3,6,9,5,5,7,6
1,14,10,11,6,9,13,5,7,6,10,10
1,13,13,12,11,6,1,5,14,10,10,10
1,5,7,7,12,9,7,5,13,15,15,14
3,5,12,11,5,5,13,7,4,10,8,10
11,5,4,11,5,5,5,13,4,11,4,10
9,5,5,13,5,5,5,5,4,9,4,8
