12
1,7,5,5,5,6,1,7,5,5,7,4
1,13,7,5,4,10,3,13,4,1,13,4
1,7,13,5,4,11,13,7,5,5,5,6
1,13,7,5,6,10,3,13,5,5,5,14
3,7,15,4,10,8,11,7,4,3,5,14
10,10,11,6,10,3,14,11,6,11,4,10
11,14,10,8,10,9,12,8,9,13,4,10
10,10,11,6,11,5,5,7,5,4,2,10
10,11,14,9,12,3,5,13,6,2,10,10
10,10,9,7,5,13,4,1,13,14,10,10
10,11,5,13,5,7,4,1,7,14,11,14
9,13,5,5,5,13,5,5,12,9,12,8
