12
1,7,5,7,4,3,5,5,5,5,5,6
1,14,1,15,5,13,5,5,7,5,5,12
3,14,3,13,5,5,5,5,13,7,5,4
10,10,11,5,5,5,7,7,4,10,2,2
10,10,10,2,3,5,13,13,7,15,14,10
8,11,12,11,14,3,6,2,10,10,10,10
1,15,4,10,10,9,13,15,14,10,11,14
3,15,4,8,11,7,5,14,10,10,10,10
10,9,5,5,12,10,1,14,8,11,15,14
11,5,5,5,5,14,1,13,7,14,10,10
10,1,5,7,7,14,3,5,13,14,8,8
8,1,5,12,8,8,9,5,5,13,5,4
