12
1,6,1,5,5,7,7,5,5,5,5,6
1,14,3,7,5,12,9,5,6,2,2,10
2,10,10,10,3,7,5,7,13,13,13,12
10,10,10,10,10,9,6,9,5,5,7,4
10,11,14,11,14,1,13,6,2,2,11,4
11,13,14,8,10,3,6,11,14,11,15,6
8,1,15,5,13,13,12,10,10,10,10,10
2,2,11,7,6,2,3,14,11,12,8,10
10,10,10,8,9,13,14,8,8,1,5,14
10,10,10,1,5,7,12,1,5,5,5,14
10,10,10,3,6,11,7,5,5,5,5,14
9,13,12,8,9,13,13,5,5,5,4,8
