12
1,5,5,5,5,7,7,5,5,7,5,6
1,5,5,5,7,14,10,3,5,12,1,12
2,3,7,5,13,13,12,11,5,5,7,6
11,15,13,5,7,5,5,12,2,3,14,10
8,11,5,4,11,5,5,6,11,12,11,14
3,13,5,5,15,7,6,11,15,4,10,10
11,7,7,4,10,9,12,10,11,5,14,10
10,10,11,4,11,4,2,10,10,2,10,10
10,10,10,2,11,5,13,13,12,11,14,10
10,10,11,15,14,2,3,6,2,10,10,10
10,10,10,10,11,14,10,9,12,10,9,12
9,12,8,8,8,9,13,5,5,13,5,4
