12
1,5,5,5,7,5,7,5,5,5,5,6
1,6,3,7,15,4,9,5,7,5,5,14
1,13,12,10,9,6,1,5,14,3,4,10
3,7,5,14,1,14,1,7,13,13,4,10
10,8,2,10,3,13,5,14,3,6,3,14
10,2,11,15,14,3,6,11,14,10,10,10
10,11,14,10,10,9,14,10,8,9,14,10
11,14,11,14,11,5,12,10,3,6,10,10
10,10,10,10,11,6,2,11,12,10,10,10
10,10,8,8,10,11,14,8,3,12,11,12
10,9,7,4,8,8,10,3,15,5,15,4
8,1,13,5,5,5,13,12,9,5,13,4
