12
1,6,2,2,2,2,3,6,2,2,2,2
3,15,15,12,11,14,10,11,15,13,15,14
10,10,10,3,12,9,12,8,10,1,14,8
10,10,9,15,5,7,5,5,12,1,13,6
10,10,2,11,5,13,5,5,4,1,7,12
10,10,10,9,6,3,6,1,7,4,9,6
10,11,15,6,11,13,12,1,13,7,5,12
11,14,10,9,15,5,5,5,5,15,7,6
10,10,10,1,15,5,5,7,5,12,8,8
10,10,9,7,13,7,5,13,5,4,3,4
11,14,1,15,4,11,7,5,5,5,15,4
8,8,1,13,5,12,9,5,5,5,13,4
