12
1,7,4,3,7,7,5,5,5,5,5,4
3,15,4,10,9,14,2,3,7,7,5,6
10,10,3,14,3,14,10,10,10,10,3,12
10,9,12,10,10,10,10,10,10,10,11,4
11,5,4,8,8,9,13,15,14,10,10,2
11,4,3,7,7,7,6,10,10,10,10,10
11,5,14,10,10,9,12,10,10,10,9,14
9,6,8,10,11,5,5,14,10,10,3,14
2,10,1,14,11,6,2,10,8,10,10,10
9,14,1,12,10,9,12,9,7,12,10,10
3,13,6,2,11,5,7,5,13,5,14,10
8,1,13,13,12,1,13,5,5,5,12,8
