12
1,7,5,5,5,5,7,7,5,5,5,4
3,13,5,5,7,4,10,9,5,5,5,6
11,7,5,5,13,4,10,2,3,5,7,14
9,13,7,5,5,5,14,10,10,3,14,10
1,5,13,7,5,5,13,14,11,14,10,10
1,5,7,13,6,3,6,10,10,11,14,10
3,5,14,1,12,11,12,11,14,10,10,10
10,1,13,5,7,12,2,10,10,10,11,14
10,1,5,5,15,4,10,11,14,10,10,10
11,5,5,7,13,5,13,14,8,10,10,10
10,2,2,10,3,5,5,13,7,12,10,10
8,9,13,13,13,5,5,5,13,5,12,8
