12
1,6,1,7,7,5,4,1,7,4,2,2
3,13,5,15,13,7,5,5,13,7,13,14
10,1,6,10,3,13,6,1,5,13,4,10
10,3,13,12,10,1,15,7,5,5,5,12
10,11,4,2,11,7,13,15,5,5,5,4
8,9,5,12,10,11,6,11,5,5,5,4
3,5,5,5,12,9,12,9,5,7,5,4
10,2,3,6,3,6,3,5,5,13,7,4
10,10,10,10,10,10,9,6,2,2,10,2
11,14,10,10,10,11,7,13,13,13,13,12
10,9,14,11,14,9,13,5,5,5,5,6
9,4,8,8,8,1,5,5,5,5,5,12
