12
1,7,7,7,6,3,4,2,3,7,5,6
3,12,10,8,8,10,2,9,12,10,1,12
11,5,14,3,5,15,13,5,5,13,7,4
11,4,11,13,4,11,5,7,5,5,13,6
11,4,11,5,4,9,4,9,5,7,4,10
10,2,9,7,4,3,6,1,5,15,4,10
9,13,5,13,6,9,13,7,5,13,4,10
3,6,2,3,15,5,5,13,5,5,4,10
10,11,14,9,13,5,5,7,7,5,5,12
8,8,11,5,5,7,5,12,11,7,7,6
2,3,15,7,5,13,5,5,14,10,10,10
9,12,9,13,5,5,5,4,8,8,8,8
