12
1,5,5,6,2,2,3,6,3,7,6,2
3,5,5,15,13,13,14,11,14,10,8,10
9,5,7,13,5,5,12,10,10,9,7,14
1,5,13,5,7,7,7,12,8,1,14,8
1,5,7,5,13,12,9,6,3,7,14,2
1,7,14,3,6,3,6,10,10,10,10,10
1,12,9,14,11,13,12,11,14,11,15,14
1,5,7,13,14,3,4,10,10,10,10,10
1,7,15,6,10,11,4,10,11,14,10,10
1,14,10,10,10,11,5,12,8,8,9,14
3,14,10,10,10,9,7,5,4,2,2,10
8,8,8,9,13,5,13,5,5,13,13,12
