12
1,5,5,5,7,5,6,3,5,7,6,2
2,2,2,3,13,5,13,12,1,12,11,14
10,10,10,11,5,5,5,5,5,7,13,12
10,10,11,15,5,7,5,5,5,14,3,4
10,10,10,10,3,13,5,5,5,14,11,4
9,13,14,9,12,3,6,1,5,13,15,4
3,7,15,5,4,11,12,3,7,7,13,4
10,11,14,2,1,15,6,10,10,11,4,2
10,10,10,11,7,14,10,10,10,11,6,10
10,10,10,10,10,10,10,10,11,12,11,14
10,10,10,10,8,8,11,15,14,1,14,8
8,8,9,13,5,4,8,8,8,1,13,4
