12
1,6,3,7,4,2,3,5,5,5,5,6
2,10,10,10,2,10,11,5,7,5,5,12
11,13,12,10,10,11,15,6,10,2,3,6
9,5,6,11,14,10,10,11,14,11,14,10
1,7,13,14,11,12,8,8,11,12,8,8
2,11,6,10,10,3,6,3,15,6,1,6
11,14,10,10,9,13,12,10,11,13,5,14
10,10,10,11,6,2,2,10,10,3,5,12
10,10,9,14,8,10,11,14,10,9,6,2
10,10,3,13,4,10,10,10,10,1,15,12
8,9,13,7,5,13,12,9,14,1,15,4
1,5,5,13,4,1,5,5,13,5,13,4
