12
1,7,5,5,5,7,5,5,5,7,5,4
3,12,3,5,7,13,5,5,5,13,7,4
11,6,11,6,11,4,2,3,7,7,12,2
10,9,14,10,11,5,14,10,8,9,4,10
9,6,10,11,15,4,9,14,1,6,2,10
1,14,10,10,10,3,6,9,7,13,13,14
3,12,10,8,8,11,12,1,13,5,4,10
11,5,14,2,3,14,3,6,3,7,5,12
11,4,10,9,14,8,10,10,10,11,5,4
10,2,10,3,15,5,14,9,12,9,7,4
11,12,10,8,11,4,11,7,5,7,15,6
9,4,9,5,13,4,8,8,1,12,8,8
