12
1,7,6,1,6,2,2,2,2,2,3,4
2,10,9,5,13,13,15,14,10,9,15,4
11,13,5,6,1,7,12,10,10,3,13,4
9,7,4,9,5,15,4,9,15,13,5,6
3,13,7,5,5,13,5,7,13,5,5,12
11,5,15,5,7,7,6,9,5,5,5,6
11,6,10,3,12,9,12,1,5,5,5,14
10,10,10,10,3,5,5,5,5,5,6,10
10,10,10,11,13,7,5,5,5,5,13,14
11,14,10,11,5,13,5,5,5,5,7,14
10,10,11,15,5,5,5,5,5,5,12,10
8,9,13,13,5,5,5,5,5,5,5,12
