12
1,6,2,1,7,7,5,5,5,4,3,6
3,15,14,2,11,13,5,5,5,6,10,8
8,8,9,13,14,1,7,5,5,13,14,2
1,5,5,7,12,1,15,4,3,6,11,14
1,7,7,15,7,5,13,6,11,14,10,10
1,14,8,8,10,3,6,10,10,10,10,8
3,12,1,5,13,13,12,11,14,10,9,6
11,7,6,3,7,5,5,14,10,11,5,14
10,10,10,10,9,5,4,11,12,9,7,12
10,10,10,11,5,5,7,13,4,1,15,4
10,10,11,15,5,5,15,5,4,3,13,4
8,8,8,9,5,5,13,5,4,9,5,4
