12
1,5,5,5,6,3,7,5,5,5,7,4
1,7,5,5,13,12,11,5,5,5,13,6
1,13,5,5,7,7,13,5,7,4,2,10
3,7,5,5,13,15,5,5,15,6,11,14
10,10,2,2,3,13,4,1,15,15,12,8
10,10,10,10,10,3,6,3,14,10,3,6
11,13,14,11,14,11,12,8,10,9,14,8
10,3,12,10,11,14,3,7,14,3,15,4
10,11,4,10,8,9,12,10,8,10,9,4
10,9,7,14,2,3,6,10,1,15,5,6
11,5,14,10,10,10,11,15,5,13,6,8
8,1,12,9,13,12,8,8,1,5,13,4
