12
1,5,5,5,7,5,5,4,1,7,4,2
2,1,5,7,13,5,5,7,5,13,7,14
11,5,5,13,7,5,7,13,5,4,10,10
10,3,5,5,15,5,12,3,4,2,10,10
10,11,6,1,15,5,5,15,6,10,10,10
10,8,9,7,12,3,6,8,9,15,14,10
10,1,5,13,6,11,12,1,5,12,8,10
11,5,7,5,13,12,1,5,5,5,7,12
11,7,14,1,5,7,7,5,5,5,15,4
10,10,10,3,5,12,9,5,7,7,13,6
10,10,10,10,2,3,7,7,15,13,4,10
8,8,9,13,13,12,8,8,8,1,5,12
