12
1,5,5,5,6,3,4,3,7,6,2,2
1,7,5,5,13,13,7,12,10,10,10,10
1,13,7,5,5,5,15,5,12,9,13,12
1,7,13,7,5,5,15,5,5,5,6,2
3,14,2,10,3,5,13,5,7,6,10,10
10,11,14,10,10,3,7,7,13,15,12,10
11,14,10,10,10,9,12,11,6,11,7,14
10,10,10,10,9,5,6,8,10,10,10,10
10,10,11,13,5,5,14,1,14,8,11,14
8,11,12,1,5,6,11,5,12,1,14,8
2,11,5,5,5,13,15,5,5,5,15,4
9,13,5,5,5,5,13,5,5,5,13,4
