12
1,7,7,7,7,6,2,3,6,2,2,2
2,10,10,10,10,10,10,10,11,15,13,14
11,14,10,10,10,10,11,12,8,9,6,8
10,11,14,10,10,11,15,5,7,5,13,4
10,10,11,14,10,10,9,5,13,6,3,6
10,10,10,11,14,11,6,1,7,13,12,10
11,14,10,10,10,9,12,3,12,3,6,10
10,10,10,10,11,5,5,13,5,14,10,10
10,10,10,10,10,3,5,7,4,8,8,10
11,14,10,10,11,15,5,13,5,5,7,14
10,11,15,12,9,13,7,5,5,5,14,10
8,8,8,1,5,5,13,5,5,5,13,12
