12
1,7,5,5,4,2,2,1,5,5,7,6
1,14,3,5,5,14,10,1,5,5,14,8
1,13,13,5,6,9,14,2,1,7,13,4
3,7,5,7,13,5,12,10,2,11,5,4
10,10,1,15,5,5,5,15,13,15,5,4
10,10,1,15,5,7,6,10,2,11,5,4
10,11,7,15,4,9,12,11,14,11,7,6
8,10,10,11,5,5,5,12,9,14,10,10
1,14,10,11,4,1,7,5,5,13,15,14
3,13,12,11,5,5,15,5,5,4,10,10
11,5,5,13,7,7,14,1,7,4,10,10
9,5,4,1,12,8,9,5,13,4,8,8
