14
1,6,2,2,2,3,5,6,3,7,5,7,6,2
2,10,11,13,13,12,1,15,14,9,6,11,14,10
10,10,10,1,7,5,5,12,10,1,14,10,10,10
9,13,13,5,13,5,5,6,8,1,14,8,11,12
3,5,5,7,5,5,5,13,5,5,13,6,9,6
11,6,3,13,4,3,5,5,5,5,7,12,3,12
10,10,9,5,7,12,3,6,3,5,15,4,11,4
10,10,1,5,13,4,9,13,14,3,13,5,13,4
11,14,3,6,3,7,7,6,10,11,7,5,5,6
10,8,10,11,14,10,10,11,14,10,9,5,6,10
9,5,14,10,10,10,8,8,11,15,6,3,14,10
1,6,10,10,10,10,1,5,14,10,11,12,11,14
1,15,12,10,10,11,7,7,14,10,10,2,10,10
1,13,5,12,9,12,8,8,9,12,9,12,8,8
