14
1,6,3,5,5,7,5,5,7,5,5,5,6,2
2,11,13,5,5,15,5,5,15,5,5,7,12,10
11,14,1,5,7,13,5,7,13,5,5,13,5,14
10,10,3,7,13,5,7,13,5,5,5,7,6,10
11,14,10,11,6,1,13,7,5,5,5,15,13,12
10,10,10,10,10,3,5,13,7,6,2,11,4,2
10,10,10,10,10,10,3,7,12,10,10,11,5,12
10,11,14,10,10,10,9,12,1,15,15,13,5,4
10,8,10,11,15,14,1,7,5,12,9,6,3,4
11,7,12,10,10,10,2,10,2,2,1,15,13,4
10,10,3,15,14,11,14,9,15,13,6,11,4,2
10,11,14,8,10,10,11,7,13,4,9,15,4,10
10,10,9,5,13,12,8,9,7,4,3,12,2,10
9,13,5,5,5,5,5,5,13,4,9,5,13,12
