14
1,7,7,6,3,5,4,3,6,2,2,3,5,6
3,12,8,11,13,5,6,10,9,14,11,14,1,14
9,5,5,15,5,5,12,9,4,10,10,10,3,12
3,5,5,13,5,5,7,7,5,13,14,10,9,4
11,5,5,5,7,5,12,9,5,6,10,10,1,6
11,5,5,5,13,7,5,5,7,12,11,14,3,14
9,7,7,5,5,12,3,6,11,4,10,10,10,10
3,13,13,4,3,5,13,12,11,5,14,10,10,10
11,7,5,4,11,7,5,5,13,5,14,11,15,14
10,11,5,5,13,13,5,5,5,7,12,10,10,10
10,9,5,7,4,2,1,7,5,13,4,10,10,10
10,1,7,13,5,13,5,13,5,5,7,12,10,10
10,2,11,7,7,5,5,5,5,7,13,5,15,12
9,13,12,9,13,5,5,5,5,13,5,4,9,4
