14
1,5,5,7,5,5,7,5,7,5,5,5,7,6
2,3,7,13,5,5,13,7,12,1,6,2,10,10
10,10,11,7,6,3,5,13,5,5,15,15,14,10
10,10,10,10,11,15,7,5,5,5,12,8,10,8
10,10,10,10,10,11,13,5,5,7,4,1,13,4
11,15,14,10,10,11,5,7,7,13,5,5,7,4
11,14,10,10,8,10,3,14,9,5,5,5,15,6
8,8,9,13,7,14,9,12,3,7,5,5,13,12
3,6,3,7,14,11,7,6,11,15,6,3,5,6
10,10,10,10,10,10,10,11,15,15,15,15,7,14
10,11,14,10,10,8,10,8,10,10,10,10,10,10
10,10,10,11,14,3,13,4,10,10,10,10,8,10
10,8,8,10,11,15,5,4,10,10,10,10,3,12
9,5,4,8,9,13,5,5,12,8,9,12,9,4
