14
1,7,7,4,1,6,3,6,1,5,6,2,3,6
3,12,9,5,5,14,10,11,5,5,15,13,12,8
11,6,3,6,2,11,14,10,3,7,13,5,5,4
10,9,12,9,13,14,10,10,11,14,1,5,6,2
10,3,4,2,3,14,8,10,8,11,5,7,15,14
10,11,7,15,14,11,5,15,6,10,1,14,10,10
11,14,10,10,10,10,3,14,10,10,1,14,10,10
10,10,10,8,10,10,9,12,11,14,1,14,10,10
10,10,11,7,13,13,7,5,12,10,3,13,15,14
10,10,10,9,5,5,15,5,4,9,13,4,9,12
10,11,14,1,5,5,13,7,7,5,4,3,4,2
10,11,14,3,5,5,5,13,15,5,4,9,5,14
11,14,11,15,6,3,5,5,13,7,5,6,2,10
9,12,8,8,9,13,5,5,5,13,4,9,13,12
