14
1,7,5,5,5,7,5,5,7,5,5,7,5,4
3,14,3,7,4,9,5,7,13,5,5,15,7,6
10,10,10,10,3,5,5,13,5,7,7,12,8,8
10,10,10,11,13,7,5,5,5,14,11,6,2,2
10,11,14,9,7,13,5,5,7,13,14,11,14,10
10,10,11,7,13,5,5,5,15,5,12,10,9,14
11,13,12,9,7,4,3,6,10,3,6,11,6,10
9,7,6,3,13,6,9,14,10,10,10,8,10,10
3,12,11,14,3,12,3,15,15,14,10,1,14,10
11,5,14,10,11,5,14,8,10,8,9,5,14,10
11,6,10,10,9,6,11,4,11,6,2,1,14,10
10,8,10,11,5,14,11,4,10,11,12,2,11,14
10,3,14,10,2,10,11,6,10,10,3,14,10,10
9,12,8,8,9,12,8,8,8,9,12,9,12,8
