14
1,7,7,6,3,5,5,7,5,5,5,5,7,6
2,10,10,11,12,1,5,13,7,5,5,5,12,10
10,10,10,10,2,1,5,5,13,7,5,5,6,10
11,14,10,10,10,1,5,7,7,15,5,5,13,12
10,11,14,10,11,5,7,12,11,15,5,6,3,6
10,8,10,9,12,3,13,4,10,9,6,10,11,14
9,7,13,4,1,14,3,7,15,7,14,10,10,10
3,13,7,5,5,12,9,12,10,10,10,11,14,10
8,1,15,5,5,5,7,7,14,10,10,10,10,10
1,7,13,5,5,5,15,14,10,10,10,11,14,10
1,13,5,7,4,1,14,10,10,10,10,10,11,14
3,5,5,13,6,1,14,10,10,11,14,10,10,8
8,1,7,5,12,3,12,10,10,9,15,14,10,2
1,5,13,5,4,9,4,9,13,5,12,8,9,12
