14
1,7,5,5,5,5,5,5,7,5,7,7,6,2
2,11,7,5,5,5,5,5,13,7,12,10,10,10
10,10,11,7,5,5,5,5,7,15,7,14,10,10
11,13,13,13,7,5,5,4,10,8,10,10,10,10
8,1,5,7,13,6,2,3,14,2,10,10,11,14
1,5,7,13,5,15,13,12,11,13,12,11,12,8
3,6,9,7,5,14,3,7,15,5,4,9,5,6
10,11,7,13,4,10,9,12,11,5,5,5,5,14
10,10,11,5,4,10,3,5,13,7,5,5,5,14
11,14,11,5,4,11,15,7,4,10,3,6,2,10
10,10,9,7,5,14,10,9,5,13,12,11,15,14
10,9,6,9,6,9,13,7,5,5,5,14,8,10
11,6,11,5,13,5,5,15,6,3,7,13,6,10
8,9,12,1,5,5,5,12,8,8,8,1,12,8
