14
1,7,5,7,5,7,5,5,5,7,5,6,3,6
1,14,3,13,5,13,6,2,3,13,4,11,14,10
1,15,13,5,5,6,9,13,15,7,6,10,10,10
3,13,5,5,4,11,6,2,10,10,11,14,11,14
9,5,5,7,4,10,11,14,10,10,10,10,10,10
1,5,5,15,5,14,10,8,11,14,11,14,10,10
1,7,5,13,4,10,11,6,10,11,12,10,10,10
1,13,5,5,6,8,9,12,10,10,1,14,9,14
3,7,5,5,15,5,5,7,15,13,5,13,6,8
10,11,4,1,15,5,4,10,11,7,7,7,12,2
10,10,2,3,13,6,2,10,8,8,8,9,6,10
10,11,15,14,2,11,15,15,7,6,2,1,15,14
10,10,10,8,9,12,10,10,8,10,10,1,14,10
9,12,8,1,5,5,12,8,1,13,12,1,12,8
