14
1,6,2,3,6,1,6,2,2,3,5,5,5,6
1,13,15,14,10,2,10,10,11,14,1,5,5,14
1,5,14,10,11,14,11,15,14,8,1,5,5,14
3,5,12,8,8,11,14,10,11,7,7,5,7,12
9,5,5,5,7,15,12,9,12,10,8,1,15,4
3,7,7,5,14,11,5,5,5,13,7,5,13,4
10,10,8,2,10,10,3,6,3,5,15,5,5,4
10,10,2,11,12,10,11,12,11,5,15,6,2,2
11,14,11,15,6,11,15,5,13,4,8,9,14,10
10,10,10,10,11,13,13,5,5,5,7,4,10,10
10,11,14,10,10,3,5,5,5,5,13,4,10,10
9,12,11,12,10,9,7,7,5,5,5,4,10,10
2,3,13,7,15,5,13,15,6,3,6,2,10,10
9,13,4,8,9,5,4,8,9,12,9,13,13,12
