14
1,7,7,5,5,7,5,7,5,5,5,5,7,6
3,12,9,4,1,15,6,11,5,5,5,5,14,10
11,5,7,5,5,13,14,10,3,6,3,7,14,10
10,3,13,4,2,1,14,10,10,11,14,10,10,10
10,11,6,2,10,1,14,10,10,8,10,10,10,10
10,10,10,11,15,7,12,8,11,4,10,11,15,14
11,12,9,14,10,11,7,6,9,4,10,10,9,14
10,3,5,12,10,10,9,12,3,7,15,14,2,10
11,15,6,2,10,11,5,5,12,8,10,10,11,14
10,10,11,13,15,13,7,5,5,5,12,10,11,14
10,10,9,7,13,7,13,5,4,2,2,10,10,10
10,10,3,15,5,13,5,5,6,11,15,14,10,10
10,11,15,13,5,5,5,7,15,12,11,12,8,8
8,9,13,5,5,5,5,12,9,5,13,5,5,4
