14
1,5,5,7,5,5,5,6,3,6,2,3,6,2
1,5,7,14,1,5,6,11,14,11,13,12,9,14
3,6,10,10,1,6,10,10,10,8,1,5,7,12
8,9,14,10,1,15,13,14,11,5,5,7,13,4
3,7,12,11,6,11,6,10,10,3,6,10,3,6
10,10,3,14,10,10,8,8,10,10,10,11,14,10
10,9,12,8,11,13,7,6,11,14,8,10,10,10
9,5,5,5,15,6,9,12,10,10,3,12,10,8
1,5,7,7,15,13,5,5,12,10,10,3,15,6
2,3,14,10,10,2,3,6,2,9,14,10,10,10
9,12,10,11,14,11,12,11,15,7,14,10,10,10
1,5,14,10,10,11,4,10,8,8,8,10,11,14
3,5,13,14,10,11,5,12,2,3,6,10,10,10
9,5,4,8,9,13,5,5,13,12,9,12,8,8
