14
1,7,7,5,5,7,6,3,7,5,7,5,5,4
3,14,9,6,1,12,9,14,11,5,13,5,7,4
10,10,3,15,5,6,3,14,11,5,5,5,15,4
10,11,12,8,3,12,10,10,10,3,7,7,14,2
10,11,5,5,15,4,10,11,14,10,11,15,13,14
11,15,6,1,13,7,12,8,11,14,10,10,2,10
10,10,10,1,5,14,3,6,10,8,10,10,9,14
10,10,8,3,5,12,9,14,9,6,10,10,3,12
10,11,5,14,2,2,1,13,5,15,14,10,9,4
10,10,3,12,10,10,2,2,3,14,8,9,5,4
10,10,10,2,11,15,15,14,11,14,1,5,6,2
10,10,11,14,10,10,10,10,8,10,3,6,10,10
10,9,12,9,12,10,10,11,7,12,8,9,13,14
9,5,5,5,5,13,12,8,9,5,5,5,5,12
