14
1,6,1,6,2,2,2,2,3,7,7,5,5,4
2,10,3,14,10,11,15,12,10,8,10,1,7,4
11,14,8,10,10,10,11,7,15,6,11,6,11,4
10,9,5,15,13,12,10,10,10,10,10,11,13,6
9,5,5,13,7,7,12,8,10,10,10,10,1,14
2,1,5,5,15,15,5,5,14,9,12,8,3,12
11,7,5,5,12,8,3,6,9,7,7,5,15,6
11,13,7,5,5,4,9,14,1,14,9,4,8,10
10,2,10,3,5,7,5,12,1,14,2,3,6,10
9,15,15,14,2,11,6,2,2,10,10,11,15,14
3,14,10,8,9,12,9,15,15,14,11,14,10,10
10,10,9,6,3,5,5,12,10,9,14,10,10,10
10,11,5,15,15,7,5,7,13,5,13,14,8,10
8,8,1,12,8,8,1,13,5,5,4,8,1,12
