14
1,7,7,5,5,7,5,5,5,7,5,7,5,4
3,12,11,5,5,13,6,3,7,13,5,13,7,4
9,5,15,5,7,7,14,10,10,2,3,6,10,2
3,6,10,3,12,10,10,8,10,10,8,10,11,14
10,11,14,10,2,10,11,7,13,13,5,13,14,10
10,10,10,11,14,10,8,9,7,4,1,7,13,12
10,11,15,14,11,14,3,6,9,6,1,13,7,4
10,10,10,10,10,10,9,13,7,12,3,6,10,2
11,14,11,14,10,9,7,5,13,4,10,9,13,12
8,10,8,11,14,1,13,5,7,5,15,5,5,4
2,10,2,10,11,5,7,5,12,3,12,2,2,2
10,11,14,9,13,5,15,5,4,10,3,14,11,14
10,10,10,1,5,5,14,3,7,15,12,11,14,10
9,12,9,5,5,5,13,12,8,9,4,8,8,8
