14
1,7,7,6,2,2,3,6,3,5,5,5,5,6
1,14,10,11,14,10,10,11,15,6,3,5,7,12
2,11,15,14,10,10,11,14,10,10,10,3,13,4
10,10,10,10,11,14,10,10,10,9,14,9,5,6
11,14,10,10,8,11,14,10,8,3,12,1,5,14
10,8,10,10,3,14,8,11,6,11,4,2,2,10
9,4,9,14,8,10,3,14,10,9,5,13,15,12
3,5,5,15,5,12,9,12,11,5,6,3,14,2
11,5,5,15,5,5,7,7,15,4,10,10,8,10
10,3,5,13,7,5,12,11,13,6,10,11,6,10
11,13,7,5,14,3,6,10,1,14,11,14,10,10
11,4,8,1,13,12,11,14,3,12,8,8,9,14
10,2,2,1,6,2,10,10,11,5,5,5,5,14
9,13,13,5,13,13,12,8,9,5,5,5,5,12
