14
1,5,5,7,4,3,5,5,6,2,3,5,5,4
3,7,5,13,7,13,5,4,11,15,14,1,5,6
8,11,5,6,10,2,3,6,10,10,9,5,5,14
1,13,6,10,10,11,14,11,14,11,7,6,3,14
1,7,12,9,13,12,10,10,8,10,10,9,14,10
3,13,5,5,5,7,14,8,3,12,9,7,14,10
9,7,5,5,5,14,11,6,10,3,7,12,11,14
1,15,5,7,7,14,9,12,10,10,11,4,10,10
3,12,1,14,8,9,7,5,15,12,9,4,10,10
10,2,2,11,5,4,11,7,13,5,5,7,12,10
10,11,15,13,7,4,10,10,3,7,5,13,5,12
10,10,10,3,13,5,14,11,15,15,5,4,3,6
11,12,8,9,7,4,10,8,10,10,3,6,10,10
9,5,4,1,13,4,8,1,12,9,12,9,12,8
