14
1,6,3,5,7,5,7,7,5,5,5,7,7,4
1,13,13,6,9,6,10,10,3,5,5,15,13,4
3,7,5,14,3,12,10,10,11,7,5,13,5,4
8,10,1,14,11,6,10,11,15,13,7,5,5,4
1,15,7,15,14,10,10,10,11,5,13,7,5,4
3,12,11,15,14,11,12,8,11,7,4,11,5,6
9,6,10,10,10,10,3,6,8,11,4,9,6,8
3,14,10,10,11,14,11,12,3,13,4,1,13,6
10,11,14,10,10,9,13,5,13,7,7,5,5,12
10,10,10,10,8,1,5,7,4,11,13,4,2,2
10,10,10,11,4,1,7,13,5,14,3,4,10,10
11,14,10,11,5,5,15,5,5,13,15,7,12,10
10,8,9,12,3,5,13,5,5,7,13,13,5,14
9,5,5,5,13,5,5,5,5,13,5,5,4,8
