14
1,6,2,3,5,7,5,5,7,5,5,5,5,6
3,12,11,14,1,13,5,5,15,5,5,4,2,10
9,6,10,10,3,7,5,7,13,7,5,4,9,14
2,11,14,9,14,9,6,11,5,13,5,4,1,14
10,10,10,2,10,3,13,14,3,5,5,7,5,12
11,15,14,10,10,11,4,9,14,1,5,13,7,4
10,10,10,11,14,10,3,6,11,5,5,7,13,4
11,14,11,14,8,10,9,14,10,2,1,15,5,4
10,10,10,11,5,15,6,10,10,10,1,13,7,4
8,8,9,13,7,14,11,14,10,11,5,7,13,4
3,5,5,5,13,14,10,10,11,14,3,15,5,6
10,2,1,7,6,10,10,11,14,10,8,8,1,14
11,15,5,14,10,10,10,8,9,13,5,5,7,12
8,8,1,12,9,12,9,5,5,5,5,5,13,4
