14
1,7,5,5,7,5,5,7,5,5,5,5,5,6
3,13,5,5,13,5,5,13,5,5,5,7,5,12
11,5,5,7,5,5,5,5,7,7,5,13,5,4
10,2,3,13,7,4,1,5,15,13,5,5,7,6
10,11,14,2,11,6,2,3,14,2,3,7,12,10
11,14,10,11,14,10,9,12,10,10,10,11,5,14
10,11,14,10,8,10,3,7,15,14,10,11,4,10
10,10,10,10,2,10,9,12,10,11,14,11,6,10
11,12,11,15,15,13,6,3,12,8,8,8,8,10
9,7,13,12,11,4,11,15,5,5,5,5,5,12
2,10,3,7,15,4,8,11,5,5,5,7,5,4
11,15,12,10,10,2,2,9,6,2,1,14,2,2
8,11,4,8,10,11,14,2,11,13,5,13,13,14
1,13,5,4,9,12,9,13,13,5,5,5,5,12
