14
1,7,5,7,7,5,6,3,6,2,2,3,7,6
3,14,2,10,9,4,11,12,11,14,11,14,10,10
10,10,10,11,7,5,15,4,10,9,12,10,8,8
10,10,10,10,10,1,13,4,11,5,7,15,6,2
10,10,11,14,11,5,5,4,8,1,12,8,11,14
10,9,12,8,9,7,5,7,5,7,5,5,12,8
11,5,5,4,1,14,3,14,3,13,5,5,5,6
9,5,7,5,5,14,9,12,11,6,1,7,6,10
2,1,13,6,1,15,5,5,14,11,7,12,10,10
11,5,5,12,3,14,2,3,12,10,11,4,10,10
11,7,5,5,12,9,14,9,6,10,11,6,11,14
8,11,7,5,5,5,12,1,15,12,8,10,8,10
2,10,10,3,6,1,6,3,12,1,7,13,5,14
9,13,13,12,9,5,13,13,5,5,13,5,4,8
