14
1,5,5,5,5,7,7,4,3,5,5,5,7,4
3,6,3,5,7,13,13,5,15,5,5,5,13,6
10,10,9,7,14,1,7,4,10,3,5,5,5,12
10,10,3,12,11,5,13,4,11,13,5,5,7,4
10,11,13,5,13,7,5,6,10,2,3,7,13,4
10,9,5,5,5,15,5,13,14,11,14,11,5,4
11,5,5,7,5,13,7,6,11,14,10,11,6,2
11,5,7,13,5,4,9,12,10,10,10,10,10,10
10,3,13,7,5,5,5,7,12,10,11,14,10,10
10,11,7,13,5,5,5,13,7,14,10,10,9,14
10,10,11,4,2,3,7,5,14,10,8,9,6,10
11,14,11,4,10,8,9,6,9,13,7,4,11,14
10,10,11,4,11,7,5,12,3,7,13,5,12,8
8,8,9,5,12,9,5,4,9,13,5,5,5,4
