14
1,5,5,6,2,3,5,4,3,5,7,6,3,6
1,5,5,14,9,13,5,7,13,6,8,10,10,10
2,3,5,14,1,5,7,12,1,15,4,11,14,10
10,10,3,15,5,5,13,5,5,15,4,10,11,14
11,14,10,9,7,5,5,5,7,14,2,10,10,10
10,9,14,1,14,3,5,5,12,9,15,15,14,10
9,6,11,7,14,10,3,7,7,5,12,10,10,10
1,12,8,10,11,14,9,12,11,4,3,13,14,8
3,7,5,13,14,9,6,2,11,5,14,3,13,4
10,10,2,2,11,6,10,10,11,4,8,9,7,6
10,10,11,14,10,11,15,14,11,5,4,1,12,10
10,10,10,10,10,10,8,10,11,5,5,5,5,14
10,9,12,11,12,9,6,9,13,5,5,7,6,10
9,5,5,13,5,5,13,5,5,5,5,12,9,12
