14
1,7,5,5,5,5,5,6,1,5,5,7,5,6
1,13,5,5,7,6,1,15,5,7,5,13,5,12
3,4,2,1,13,14,1,15,6,9,5,7,5,4
11,6,10,2,2,10,3,12,10,1,7,12,3,4
10,10,10,10,11,15,15,6,10,1,13,5,13,6
10,10,11,15,14,10,8,8,11,5,7,5,5,12
11,15,14,10,10,10,3,6,11,7,13,5,5,4
10,11,14,10,10,10,9,14,11,13,5,5,7,4
10,9,14,10,10,11,7,15,13,5,5,7,13,6
11,4,10,10,9,12,10,8,1,5,5,14,3,12
11,6,10,11,5,7,14,2,3,7,5,13,13,4
8,10,11,13,5,12,11,14,10,9,7,6,3,6
3,12,9,5,7,4,8,11,15,7,12,11,14,8
9,5,5,5,13,4,1,12,8,9,4,8,9,4
