14
1,7,6,2,1,5,5,7,7,5,6,3,5,6
3,14,9,13,5,5,7,12,11,4,9,12,1,14
8,9,7,5,7,5,13,4,9,7,5,4,2,10
3,7,14,3,13,5,5,7,7,15,5,5,13,12
10,10,10,9,7,4,2,10,9,15,5,7,7,6
10,10,11,7,13,5,12,8,3,12,2,10,8,10
10,11,12,11,5,5,7,6,11,5,14,9,4,8
10,10,2,9,6,2,9,12,11,7,14,3,5,6
11,14,10,3,12,11,7,5,14,8,11,14,1,14
10,10,11,13,7,14,8,1,13,6,10,10,1,14
11,14,8,1,14,8,1,7,5,12,8,8,3,12
10,10,3,6,10,3,7,15,7,7,5,5,13,4
10,8,8,11,13,12,8,10,9,13,5,7,5,4
9,5,5,13,5,4,1,13,5,5,5,13,5,4
