14
1,6,3,5,7,5,7,7,5,7,5,5,5,6
1,15,12,1,15,4,8,10,1,13,7,5,5,12
3,13,5,6,10,3,6,11,7,5,13,5,5,6
11,5,6,9,13,12,11,13,15,5,5,5,7,14
10,3,13,5,5,7,12,1,15,5,5,6,10,10
11,13,5,5,5,15,5,5,13,7,4,10,10,10
11,5,5,5,5,13,7,6,2,11,6,10,10,10
9,5,5,5,7,6,9,12,10,10,11,12,10,8
2,3,7,7,14,11,6,3,14,10,10,3,13,4
10,10,10,11,14,10,9,12,9,15,14,11,4,2
11,13,15,14,10,10,3,7,5,14,11,14,2,10
10,2,10,10,11,13,14,10,2,10,8,11,13,12
9,14,10,10,11,4,10,10,11,14,1,13,5,6
1,12,8,8,9,4,8,8,8,8,1,5,5,12
