14
1,5,5,5,7,5,5,5,5,6,1,5,7,6
3,5,5,7,13,5,5,7,5,13,7,5,12,10
10,2,3,15,5,5,5,13,7,4,9,5,6,10
9,15,13,15,7,5,5,5,13,7,6,2,10,10
1,15,5,15,13,5,5,5,6,10,10,10,11,14
3,15,6,11,5,7,7,5,14,10,10,9,14,10
10,10,10,11,5,14,11,6,10,10,10,1,14,10
10,10,10,10,3,14,9,12,10,8,9,7,13,12
10,10,8,10,11,13,5,7,13,5,7,13,5,6
11,15,5,12,10,1,7,13,5,5,15,5,4,10
8,9,7,4,8,1,15,7,5,5,13,6,3,14
2,3,14,2,2,1,15,15,6,3,6,10,10,10
10,10,10,11,14,1,14,10,11,14,11,15,14,10
9,12,9,12,9,5,12,8,8,8,8,8,8,8
