14
1,6,1,6,2,3,5,5,7,5,5,5,6,2
3,15,5,15,14,11,6,2,11,5,7,5,13,12
8,10,1,14,10,10,9,13,12,3,14,1,7,4
3,14,1,14,10,9,5,7,4,10,10,1,15,4
10,10,1,14,9,5,5,13,7,14,10,1,13,6
10,10,2,11,7,7,5,5,12,10,10,1,7,14
10,10,10,10,8,10,3,6,3,15,15,7,15,14
10,11,15,14,1,14,11,12,10,10,10,10,10,10
11,14,10,10,1,13,15,5,12,9,12,11,14,10
9,14,8,9,5,7,13,7,5,5,4,10,10,10
1,15,4,3,4,10,2,9,5,7,5,12,10,10
3,13,4,9,6,11,14,1,5,13,5,6,11,14
11,7,7,7,14,10,11,5,7,5,5,12,8,10
8,8,8,8,9,12,9,5,13,5,5,5,5,12
