14
1,6,3,5,7,5,5,5,6,3,5,5,7,4
1,13,13,7,13,6,2,2,11,15,5,6,11,6
1,5,5,15,5,13,15,12,8,10,3,12,10,10
1,5,5,15,5,5,15,4,2,10,11,4,10,10
3,5,5,15,5,5,13,4,10,10,11,6,10,10
11,7,5,13,5,5,7,5,14,10,8,11,14,10
11,15,5,5,7,6,11,6,11,13,5,14,9,12
10,11,4,3,14,10,9,12,11,5,5,13,5,6
11,15,4,10,10,11,5,5,15,7,5,5,7,12
10,9,7,12,10,11,5,5,14,10,3,6,10,2
10,3,15,6,11,15,4,2,11,14,10,10,10,10
10,10,8,8,10,10,2,10,10,10,10,11,14,10
10,10,2,3,14,11,14,10,10,11,14,10,10,10
8,9,13,12,9,12,9,12,8,8,8,8,9,12
