14
1,7,7,7,7,7,5,5,7,5,5,7,5,6
1,12,10,8,10,9,5,7,13,7,4,8,1,12
2,1,13,6,11,5,5,12,1,15,5,5,5,4
11,7,5,12,11,5,5,5,5,15,6,2,3,6
8,9,7,4,11,5,5,4,3,12,11,15,14,8
3,7,13,6,11,5,5,5,15,6,10,10,11,6
10,8,3,13,14,2,3,6,10,9,14,10,8,8
10,3,15,5,15,12,9,13,14,3,15,13,5,6
10,11,14,3,15,6,3,5,14,10,10,1,7,12
10,10,10,10,11,14,11,4,10,10,8,3,15,6
10,10,10,10,10,11,14,2,11,14,2,10,10,10
10,10,10,10,10,10,10,11,14,10,10,8,8,10
10,10,9,12,10,10,11,14,10,9,15,5,5,12
8,9,5,5,12,8,8,8,9,5,13,5,5,4
