14
1,5,6,3,6,3,6,2,2,2,2,3,6,2
3,5,15,12,9,14,10,10,11,15,15,12,10,10
10,1,12,1,5,14,10,11,14,10,10,3,12,10
11,5,7,5,5,12,11,14,11,12,10,9,5,12
11,5,13,7,5,5,14,10,10,2,10,3,7,6
11,5,5,15,5,5,12,8,10,10,11,14,8,10
10,2,2,11,5,6,3,7,14,10,10,10,2,10
11,13,14,10,3,12,9,12,9,15,14,11,14,10
10,2,11,14,10,3,7,5,5,12,10,8,10,10
10,9,14,10,9,14,11,5,4,1,13,7,13,14
10,1,14,9,5,15,13,6,2,2,1,14,3,12
10,2,10,2,2,10,3,13,15,15,5,12,9,4
11,15,13,13,13,12,11,4,11,15,7,4,1,6
8,9,5,5,5,4,9,4,8,8,9,5,5,12
