14
1,7,5,7,5,5,5,5,7,5,7,5,5,4
1,13,6,9,5,7,5,4,9,7,13,5,6,2
1,5,13,7,5,15,6,2,2,11,6,2,10,10
3,5,5,13,5,12,9,12,11,12,9,12,9,12
11,5,7,5,5,5,7,6,11,5,5,5,5,6
11,7,14,3,5,6,8,9,14,3,7,6,2,10
8,10,9,12,3,12,3,6,11,14,10,9,14,10
2,10,2,2,10,3,13,12,10,8,10,1,15,14
10,10,10,11,13,14,2,1,15,4,10,2,10,10
10,10,11,14,1,14,10,1,13,6,8,9,14,8
11,15,14,10,1,15,15,5,5,13,7,4,11,6
10,10,10,11,5,12,9,7,5,4,10,3,14,10
10,9,15,13,4,2,2,10,1,5,13,14,8,10
8,1,13,5,5,13,13,13,5,5,5,12,1,12
