14
1,5,6,3,7,5,7,7,7,5,4,2,2,2
3,5,12,10,10,2,10,11,13,5,6,11,15,14
11,5,5,14,10,11,14,10,1,7,12,10,10,10
11,5,4,8,8,10,11,14,3,13,7,12,8,8
9,7,5,5,5,15,14,10,11,5,15,5,5,4
3,13,5,5,5,14,8,8,11,5,13,5,5,6
11,5,5,5,5,14,3,6,9,5,5,5,7,14
11,6,2,2,2,10,11,12,3,7,6,3,13,12
10,10,10,11,14,10,10,2,8,8,11,14,2,2
11,14,10,8,10,11,15,14,3,5,12,9,13,14
10,11,14,2,10,10,10,10,11,6,2,2,2,10
10,10,9,13,13,14,8,10,10,11,14,11,14,10
10,11,5,5,5,13,6,11,14,10,10,10,10,10
9,13,5,5,5,5,12,8,8,8,9,12,9,12
