14
1,7,6,3,7,7,6,3,5,5,4,3,6,2
2,10,9,12,10,10,11,15,5,5,5,14,10,10
10,9,7,7,14,11,14,9,5,5,6,8,9,12
9,5,12,10,10,10,10,3,5,5,13,5,7,6
2,2,2,10,10,10,10,11,7,5,5,7,12,8
10,10,11,14,10,10,9,12,9,7,5,13,4,2
11,14,10,9,14,11,7,6,1,15,6,1,6,10
8,11,13,4,10,10,9,12,1,14,11,5,14,10
1,15,5,6,10,11,7,5,5,14,8,1,12,10
3,13,4,10,11,14,10,1,7,13,7,5,5,12
9,7,7,14,10,10,8,3,13,5,15,5,5,4
3,14,10,10,11,12,3,13,7,5,13,5,6,2
10,8,8,11,15,4,11,5,13,5,5,5,13,14
9,5,4,8,9,5,13,5,5,5,5,5,5,12
