14
1,5,7,5,5,5,7,5,4,1,5,5,7,4
2,2,11,7,5,6,9,7,5,5,5,5,13,6
10,11,14,9,4,10,3,13,5,5,5,7,7,14
10,10,11,7,6,11,15,5,5,5,6,10,10,10
11,14,10,10,10,10,11,7,7,6,10,11,14,8
10,10,10,8,11,12,8,8,10,10,10,10,10,2
10,10,10,3,13,6,3,6,8,10,11,14,11,14
9,14,10,8,3,12,9,13,6,11,14,10,10,10
3,12,10,3,13,7,5,7,15,12,9,12,8,10
9,7,15,15,7,15,4,8,9,5,5,6,2,10
3,14,10,10,10,11,4,3,5,7,6,10,10,10
10,10,10,10,11,15,4,11,4,10,10,10,11,14
10,11,15,14,10,11,4,11,4,8,11,15,14,10
8,8,8,8,8,9,5,13,5,4,8,8,8,8
