14
1,7,5,7,5,5,4,1,5,5,6,2,2,2
3,14,1,15,5,5,4,1,7,7,14,11,14,10
10,11,5,13,7,7,5,5,12,8,11,14,11,14
10,9,4,1,15,12,1,5,7,5,12,8,10,10
9,5,7,5,13,7,5,7,15,5,5,5,14,8
1,5,13,6,2,10,1,14,11,5,5,5,13,6
2,1,7,15,13,14,3,14,11,5,5,5,5,14
11,7,12,10,3,12,9,12,11,5,5,7,5,12
10,10,3,14,11,5,6,2,11,7,5,13,5,6
10,10,10,11,15,4,10,10,10,9,5,7,5,14
10,11,12,10,11,4,10,10,10,3,5,13,4,10
10,9,6,9,13,5,15,15,14,9,5,7,6,10
10,2,11,6,2,2,10,10,11,5,7,12,8,10
9,13,12,9,13,12,9,13,12,1,13,5,4,8
