14
1,5,7,4,1,5,7,5,7,6,2,2,1,6
1,7,13,4,1,7,13,4,11,14,11,14,3,12
1,13,7,4,3,13,5,4,10,10,10,10,9,6
2,1,13,6,9,5,5,6,10,9,15,15,7,12
9,5,5,15,5,7,4,10,10,3,12,10,11,4
3,5,6,10,1,15,5,13,14,9,6,10,11,6
9,6,9,12,3,12,3,6,11,5,12,11,12,8
1,15,5,5,15,4,9,14,11,5,5,13,5,6
1,13,5,7,13,7,6,10,10,3,5,5,5,12
3,6,2,10,1,14,10,10,11,15,5,5,5,4
10,11,15,15,7,12,10,11,14,9,5,6,2,2
10,10,8,8,9,4,11,12,8,1,5,14,10,10
11,13,5,5,5,5,14,2,3,6,2,10,10,10
9,5,5,5,5,5,13,13,12,9,13,13,13,12
