14
1,5,7,5,4,3,5,5,5,7,5,7,5,4
1,5,15,5,5,13,5,7,7,14,3,15,6,2
3,5,13,5,5,7,5,12,10,11,12,8,9,12
10,3,5,5,5,15,5,7,14,10,1,7,5,6
8,11,5,6,3,12,1,14,11,14,1,13,6,8
3,13,6,10,11,5,5,12,10,11,5,5,13,6
11,6,10,10,11,4,3,6,10,10,3,5,7,12
10,8,8,9,13,6,9,13,12,10,8,3,15,6
11,5,7,7,6,9,5,7,4,11,6,8,8,10
11,6,10,10,10,1,5,15,5,14,10,3,7,14
10,8,10,10,10,3,5,13,4,10,10,10,8,8
11,6,11,14,11,15,5,5,4,10,11,14,3,4
10,10,10,10,10,10,2,3,4,10,8,9,13,6
8,9,12,8,8,9,13,13,5,13,5,5,5,12
