14
1,5,5,7,4,3,5,5,5,7,5,5,5,4
3,5,5,15,5,15,5,5,5,13,5,6,2,2
10,3,7,15,7,13,7,5,5,5,6,11,14,10
10,10,11,14,9,6,11,7,5,5,13,12,11,14
10,11,14,10,3,13,12,9,5,5,7,5,14,10
10,10,10,10,9,7,5,5,7,7,13,4,8,8
10,10,10,11,7,12,3,7,13,13,7,4,3,4
10,8,8,10,9,4,9,12,1,7,13,4,9,6
11,5,7,13,5,5,7,5,5,15,5,6,1,14
10,2,11,4,1,7,13,4,3,15,5,14,1,14
10,10,9,7,7,13,5,4,8,9,6,11,5,14
11,14,3,13,13,5,5,5,6,3,12,10,3,12
10,10,11,7,5,5,5,4,11,13,6,10,11,4
8,9,13,13,5,5,5,4,8,1,12,9,13,4
