14
1,6,2,3,5,7,5,5,5,7,7,6,2,2
1,13,13,13,7,15,5,5,5,13,12,10,11,14
2,2,2,3,15,13,5,5,5,6,3,15,14,10
10,10,10,10,11,5,6,3,6,10,11,12,10,10
11,15,15,14,10,3,13,12,9,12,10,1,15,14
10,8,10,8,9,15,5,5,7,4,10,3,12,10
10,1,15,4,2,11,7,6,11,7,14,11,4,10
11,7,13,4,11,12,9,12,10,10,10,11,4,10
10,9,7,5,15,5,5,4,10,10,9,14,3,14
11,5,15,5,13,4,2,2,10,9,6,9,12,8
11,5,13,7,5,5,13,14,10,2,11,7,7,6
10,2,2,9,5,7,5,15,15,14,10,10,8,8
11,13,13,5,5,14,1,14,8,9,12,9,7,4
9,5,5,5,5,12,1,13,5,5,5,5,13,4
