14
1,6,2,1,5,7,5,4,1,5,5,5,7,6
1,14,10,2,1,13,7,6,2,1,7,5,12,10
3,12,11,13,7,5,12,11,14,3,13,6,2,10
11,6,10,1,13,5,6,8,9,15,4,11,12,10
10,8,10,2,1,7,13,7,5,13,4,11,6,10
11,4,10,10,2,11,5,13,5,5,6,10,11,14
11,4,10,11,14,10,3,7,5,7,14,10,8,8
11,5,15,14,11,14,9,12,3,14,11,15,5,4
11,4,8,8,10,11,5,5,14,8,9,13,5,6
10,1,5,7,14,9,5,5,15,4,3,7,6,10
11,5,5,12,10,3,6,2,9,7,14,10,10,10
9,7,5,4,10,10,9,12,2,10,8,8,11,14
1,15,5,5,13,13,7,6,11,14,3,5,14,10
1,13,5,5,4,1,12,9,12,8,8,1,12,8
