14
1,7,6,3,7,6,3,7,5,5,7,5,5,4
1,14,9,12,10,9,15,13,5,5,13,7,6,2
3,13,5,7,13,4,10,3,7,7,7,15,12,10
9,5,5,13,6,3,14,8,8,8,8,9,6,10
3,5,5,5,13,14,10,3,5,5,7,5,13,14
11,7,5,5,5,12,8,9,5,5,15,5,4,10
9,15,4,2,1,6,3,6,3,5,15,5,5,12
3,13,4,11,5,15,13,12,11,7,15,6,3,6
11,5,7,14,3,13,5,7,13,14,10,10,10,10
11,6,10,8,9,4,1,13,6,10,10,10,10,10
10,10,10,1,7,4,1,6,10,11,14,10,10,10
10,10,10,1,13,7,5,13,14,10,11,15,14,10
10,10,11,7,5,12,3,5,12,8,8,10,9,14
8,9,12,9,5,4,9,5,5,5,5,12,1,12
