14
1,5,7,6,1,7,5,5,7,5,5,5,7,4
3,7,12,10,1,13,6,2,10,1,5,7,13,6
10,9,4,11,5,7,12,9,14,1,5,12,3,12
11,7,4,10,1,13,6,1,13,7,5,5,15,4
8,9,6,8,3,5,13,5,7,15,4,2,10,2
3,4,11,5,14,3,5,5,14,9,7,14,10,10
9,5,15,4,10,10,3,7,12,1,14,8,11,14
1,5,13,6,11,14,9,12,3,5,13,5,12,10
2,2,3,15,14,9,5,6,10,1,5,7,6,10
11,15,12,8,8,1,7,13,15,6,1,15,14,10
11,14,1,7,5,5,15,4,8,9,5,14,10,10
8,11,5,13,5,6,9,6,2,2,2,10,10,10
3,13,5,5,5,15,5,15,14,11,13,12,11,14
8,1,5,5,5,12,1,12,9,13,5,4,9,12
