14
1,7,7,5,7,4,2,3,5,5,6,2,3,4
3,12,9,6,11,5,13,14,1,7,13,12,10,2
10,2,3,12,10,2,3,12,3,13,5,4,11,14
11,15,15,4,10,10,9,6,10,2,3,4,10,10
10,10,9,7,14,10,3,12,11,15,13,5,12,8
8,8,3,12,9,15,13,5,13,15,5,5,5,6
3,6,11,5,7,12,3,7,7,13,5,5,5,14
10,10,10,2,10,2,9,12,11,6,3,5,7,14
10,10,10,10,10,10,2,2,10,10,11,7,14,10
10,9,14,11,14,10,10,9,14,11,14,10,10,10
10,2,11,14,11,15,15,6,10,10,10,10,8,8
10,11,12,8,10,8,8,9,12,8,10,11,6,2
10,10,1,7,13,7,7,6,3,7,12,8,9,12
9,13,5,13,4,8,8,9,13,13,5,5,5,4
