14
1,6,3,7,7,6,2,2,3,5,7,5,5,4
3,13,12,10,10,10,10,11,13,5,15,5,5,4
9,5,6,8,10,10,10,9,5,5,15,4,2,2
3,7,15,7,14,10,10,2,2,1,15,7,14,10
10,11,14,10,11,15,15,13,15,5,12,8,10,10
11,14,10,10,10,10,11,5,15,5,7,5,13,12
10,10,10,11,13,14,11,6,11,5,13,7,5,4
10,10,11,14,1,14,9,12,11,5,5,13,7,4
10,10,10,10,1,13,5,5,15,6,1,7,13,4
11,13,14,8,1,5,5,5,14,10,2,9,5,6
10,3,14,3,7,6,2,2,10,11,14,3,7,12
10,10,11,12,10,11,14,11,14,10,9,12,9,6
11,14,10,1,14,10,10,10,10,10,1,7,7,14
8,8,8,1,12,8,9,12,9,13,5,12,8,8
