14
1,5,7,5,4,3,5,5,6,2,2,3,7,6
3,5,13,5,4,10,1,7,12,10,11,14,8,10
11,5,7,5,6,10,1,13,6,10,10,8,1,14
9,4,11,4,9,12,3,5,15,15,13,6,1,14
3,5,13,7,5,5,15,5,14,8,1,12,3,12
9,7,5,15,7,4,9,5,15,6,2,3,15,4
1,13,6,10,9,6,3,7,14,8,10,10,11,6
1,5,14,10,2,10,9,12,9,6,10,10,8,10
1,7,14,10,10,10,3,5,5,15,13,12,1,14
3,14,10,11,15,14,9,5,5,15,5,4,1,14
10,8,11,14,10,10,3,5,5,13,7,5,5,14
10,2,11,12,8,11,13,5,7,5,13,5,7,14
10,10,11,4,3,13,5,7,12,1,5,6,10,10
9,13,13,5,13,5,4,9,5,5,5,13,13,12
