14
1,7,4,3,6,3,6,2,2,2,2,2,1,6
2,11,7,14,11,14,10,10,11,15,15,14,3,14
10,10,10,10,10,11,14,11,12,10,8,9,12,8
10,10,10,10,10,10,11,14,3,13,5,5,7,4
11,14,10,10,8,8,8,10,11,5,5,7,13,4
10,10,10,9,7,4,1,13,15,4,3,15,5,6
10,10,10,3,15,6,3,6,11,7,12,8,1,12
11,15,12,8,10,9,13,12,11,13,5,5,5,6
10,10,3,7,13,6,3,7,13,5,5,4,3,14
8,11,14,10,3,12,10,11,5,5,5,4,10,10
1,14,8,10,9,7,15,14,3,5,5,5,14,10
2,11,5,14,2,10,10,10,9,7,5,4,10,10
11,13,4,11,15,15,14,11,6,11,4,3,14,10
9,5,4,8,8,8,8,8,9,13,5,12,9,12
