14
1,5,5,5,7,5,7,7,5,7,5,5,4,2
1,7,5,5,15,6,10,9,7,15,5,5,4,10
1,15,5,4,10,11,14,2,10,10,3,6,2,10
3,13,5,4,10,10,10,11,14,10,10,9,15,14
9,5,7,4,11,14,10,10,11,15,13,5,12,10
1,5,15,4,10,10,9,12,10,11,6,3,5,14
3,7,13,5,12,8,3,6,10,10,10,10,3,14
10,10,3,6,2,2,9,13,13,12,10,10,10,10
10,10,10,11,14,11,4,2,3,5,12,10,10,10
11,13,14,10,10,9,7,15,15,5,5,13,15,14
10,3,15,14,10,1,14,10,9,5,5,4,10,10
11,12,10,10,11,5,14,11,7,5,5,5,12,10
10,3,12,8,9,7,12,10,9,5,5,7,5,14
8,9,5,5,5,13,5,13,5,5,5,13,4,8
