14
1,5,5,5,5,7,5,5,6,3,4,2,2,2
1,7,5,5,7,12,3,5,12,9,6,11,14,10
3,13,5,7,13,4,9,5,7,7,13,12,9,14
10,2,2,9,6,2,1,5,15,15,5,5,6,10
11,13,15,5,13,12,3,7,12,11,7,6,10,10
11,5,13,5,7,5,12,11,7,14,10,10,11,14
11,5,5,5,15,4,3,14,10,8,11,14,11,12
11,5,5,5,15,4,9,12,10,3,12,10,11,6
11,5,4,3,13,5,7,5,12,9,6,11,14,10
9,5,6,11,5,6,9,5,4,1,12,10,8,8
2,2,11,15,5,13,7,5,4,2,2,11,7,4
10,10,10,11,5,7,13,5,4,10,10,10,11,6
11,13,14,11,5,13,5,7,5,14,9,12,8,10
8,1,12,9,5,5,5,13,4,9,5,5,5,12
