14
1,6,3,5,7,4,3,5,4,3,6,1,6,2
3,13,12,1,13,7,13,5,5,12,10,2,10,10
9,7,5,5,5,13,7,4,2,3,15,14,10,10
3,13,7,5,7,5,13,5,13,12,8,9,15,12
11,6,9,5,15,5,5,5,7,5,5,5,15,4
10,8,3,5,13,7,5,5,14,2,3,5,13,4
11,7,14,1,5,14,3,6,10,10,11,7,7,4
10,10,10,3,5,12,9,14,10,11,14,10,9,6
10,10,11,13,5,7,5,14,9,14,11,14,2,10
10,10,10,1,5,13,6,10,1,14,10,10,11,14
10,10,10,1,7,5,14,10,2,10,10,11,14,10
11,14,10,3,13,4,10,11,15,12,8,8,8,10
10,10,10,9,7,4,11,14,11,7,5,5,4,10
9,13,13,5,13,4,8,9,12,9,5,5,5,12
