14
1,5,5,7,5,5,6,3,6,3,5,6,2,2
3,6,2,11,5,5,15,12,9,15,6,11,15,14
10,11,14,11,5,5,13,7,5,14,10,10,10,10
10,10,10,11,6,3,6,11,6,11,14,10,10,10
10,10,10,10,10,10,10,10,11,14,11,14,10,10
11,12,9,14,10,10,9,12,10,10,10,11,13,14
11,5,7,13,13,14,3,6,10,10,10,11,6,10
8,1,15,4,3,12,9,14,8,10,11,15,12,10
3,6,11,4,9,7,5,13,5,12,8,9,5,14
10,11,15,5,5,13,5,6,2,2,1,7,5,12
11,15,14,2,2,2,2,11,15,13,5,13,5,6
10,10,10,11,14,11,12,10,9,5,7,5,4,10
10,10,9,12,9,15,5,15,7,5,13,5,5,14
8,9,5,5,5,13,4,9,13,5,5,5,4,8
