14
1,6,2,1,7,5,5,5,7,6,3,6,2,2
3,15,13,5,13,6,3,4,10,11,14,10,10,10
10,9,4,1,5,14,9,7,14,8,8,11,13,12
9,5,5,5,7,14,1,12,9,7,5,13,5,6
3,5,5,5,13,15,5,5,7,13,7,5,6,10
11,5,5,5,5,12,1,5,15,7,14,2,10,10
11,5,5,4,2,2,3,6,10,10,11,14,11,12
11,7,5,7,15,13,13,12,10,10,8,11,15,4
10,10,3,12,9,7,5,5,12,10,2,10,11,6
10,11,15,4,1,13,5,7,4,9,14,10,10,10
10,10,11,7,7,5,5,13,7,4,10,11,14,10
11,14,10,10,11,5,5,5,15,5,14,10,11,14
10,10,8,9,15,7,7,5,13,6,11,14,10,10
8,9,5,5,12,8,9,5,4,8,8,8,8,8
