14
1,6,2,3,7,7,5,4,2,2,2,1,6,2
3,13,14,10,8,9,5,5,15,15,14,3,13,12
9,6,8,11,5,5,5,4,10,10,10,11,5,6
3,13,5,15,5,7,7,4,10,10,11,13,4,8
9,5,6,9,6,10,11,6,8,8,9,5,6,2
3,5,12,3,12,10,9,13,7,5,5,5,15,12
9,5,5,15,4,10,3,6,11,7,6,2,10,2
3,7,5,13,4,10,11,12,10,10,9,14,11,12
10,9,7,7,7,14,10,3,14,10,1,13,13,4
10,2,10,10,10,10,11,14,10,11,6,3,5,6
11,14,11,14,10,10,10,10,9,14,11,12,3,12
10,10,10,10,10,10,10,10,3,12,8,1,15,4
10,11,14,10,11,13,12,10,9,5,7,4,11,6
9,12,8,9,12,1,5,13,5,5,13,5,12,8
