14
1,5,5,7,5,4,1,5,7,7,4,1,7,6
2,3,5,15,4,2,1,7,12,9,5,5,14,10
11,15,7,15,5,13,7,13,5,7,5,5,12,10
10,10,11,15,5,4,9,7,4,11,5,5,6,10
10,10,10,9,5,6,1,13,5,13,7,7,12,8
10,10,10,3,7,15,5,5,7,5,15,13,5,6
11,12,8,10,10,11,7,6,9,6,8,1,5,14
10,2,3,14,11,14,9,12,1,13,5,7,5,14
9,15,14,10,11,15,7,5,5,7,7,13,6,10
3,12,10,11,14,10,10,2,3,12,9,4,9,14
11,4,10,10,10,10,10,10,9,7,7,7,7,12
11,4,10,10,10,10,11,14,1,14,10,8,9,4
10,2,9,12,10,8,10,11,7,12,11,5,5,6
9,12,1,5,13,5,12,8,9,4,8,1,5,12
