14
1,5,7,5,5,5,7,5,7,6,3,6,3,6
2,3,14,2,2,2,11,7,14,10,10,10,10,10
10,10,10,11,14,10,10,10,10,10,10,9,14,8
11,14,10,10,10,10,10,8,8,9,15,7,13,4
8,8,9,14,10,11,15,6,3,5,14,9,7,4
1,5,5,14,10,10,8,10,11,4,8,1,13,6
1,7,5,13,15,12,3,14,9,5,7,5,5,14
1,15,5,5,13,4,9,12,1,5,15,5,5,12
1,13,5,7,6,3,4,3,5,7,13,5,7,4
2,2,3,12,9,13,7,12,1,15,5,4,9,6
10,10,11,4,2,1,15,6,3,13,6,2,3,14
10,10,11,4,11,5,14,10,11,4,8,11,12,10
10,10,10,3,14,3,14,11,14,2,2,10,3,12
9,13,13,12,8,8,8,8,9,13,13,12,9,4
