14
1,7,5,5,5,5,5,6,3,7,5,5,7,6
3,13,7,4,3,5,5,13,12,9,7,4,9,14
10,1,15,4,9,7,7,5,5,5,13,5,4,10
10,3,13,7,7,13,13,5,7,5,5,5,6,10
10,8,1,14,11,5,7,7,13,5,5,5,14,10
10,1,7,12,10,3,13,15,6,3,6,2,10,10
11,5,13,5,13,14,3,14,10,10,10,10,10,10
9,5,5,7,4,10,9,12,11,14,11,14,10,10
3,5,5,13,4,10,3,7,14,8,8,9,12,10
11,7,5,5,4,9,12,9,15,5,4,3,4,10
10,10,2,3,6,3,5,5,15,5,4,9,7,12
11,14,11,14,11,14,2,2,11,5,5,5,13,6
10,11,14,10,8,9,15,13,13,5,5,7,5,12
8,8,8,9,5,5,13,5,5,5,5,13,5,4
