14
1,7,6,2,2,2,3,6,1,7,5,5,5,6
2,10,10,10,10,11,14,9,5,15,4,1,7,14
10,10,8,11,14,10,11,7,5,13,5,5,14,10
10,11,7,14,11,12,10,9,5,5,7,5,14,10
11,12,10,8,11,4,11,5,5,5,15,5,13,14
10,1,15,7,15,4,9,5,7,5,13,5,6,10
10,3,12,10,10,2,3,6,10,3,7,5,12,10
9,15,4,11,15,14,11,12,10,8,9,7,5,12
2,9,7,14,10,10,11,7,12,1,5,15,5,4
10,2,10,10,8,9,12,9,6,3,5,13,5,4
10,11,12,8,3,5,5,6,11,13,5,5,6,2
11,13,6,2,11,5,7,13,13,7,5,4,11,14
10,2,10,11,13,7,13,5,5,13,5,4,10,10
8,9,13,13,5,13,5,5,5,5,5,5,12,8
