14
1,6,3,7,7,5,5,7,7,5,5,5,5,4
2,9,12,8,11,7,6,10,11,5,5,5,5,6
11,5,7,6,10,10,10,10,9,6,2,3,6,10
10,2,10,10,10,10,11,14,1,13,13,14,10,10
10,11,14,9,15,14,10,10,1,7,5,12,10,10
8,10,10,2,10,10,8,9,5,13,5,7,15,14
3,13,14,11,14,10,3,6,1,5,7,14,10,10
11,6,11,14,10,10,9,14,3,5,15,14,11,12
10,8,9,12,8,9,5,15,12,2,10,10,11,4
9,5,5,5,7,5,5,15,4,11,12,10,11,4
1,5,7,5,14,2,3,14,2,10,2,10,9,6
1,5,13,6,8,9,12,11,13,15,12,10,2,10
1,7,6,11,5,5,7,13,4,9,5,12,10,10
1,12,9,13,5,5,13,5,5,5,5,4,9,12
