14
1,7,7,6,2,3,7,7,5,5,5,5,7,4
2,10,10,11,15,15,14,10,1,7,5,5,13,6
10,10,10,10,10,10,10,9,5,15,5,5,4,10
11,15,14,10,8,10,10,3,7,13,5,5,5,14
10,10,10,11,5,14,10,10,8,1,7,6,2,10
10,8,8,9,4,10,9,13,6,1,14,10,10,10
11,5,5,5,5,14,3,7,14,3,12,9,13,12
10,3,5,6,3,14,9,12,11,14,3,5,5,4
10,11,6,9,14,9,7,5,12,9,13,7,5,4
10,10,10,3,12,2,11,5,6,2,3,12,1,6
11,15,14,9,6,10,11,4,11,13,15,5,5,12
10,10,10,2,10,10,10,2,9,5,13,7,5,4
10,10,11,15,15,14,10,11,5,5,5,15,5,4
8,8,8,8,8,9,13,13,5,5,5,13,5,4
