14
1,5,7,6,2,3,6,2,3,7,4,3,6,2
1,6,10,11,13,14,11,15,12,11,5,12,9,14
3,13,12,11,4,8,10,10,3,12,3,5,6,10
10,3,6,10,2,3,14,10,9,6,11,5,14,10
10,10,10,10,10,10,8,8,3,13,13,6,10,10
10,10,10,11,14,10,1,5,15,5,7,12,10,10
11,14,9,12,9,12,3,6,9,6,9,4,11,12
11,13,5,7,5,4,9,13,6,9,7,5,15,4
10,1,7,13,7,5,5,7,13,5,13,6,11,6
10,2,11,5,14,3,5,13,5,7,5,13,12,10
10,11,12,3,12,11,6,3,5,13,5,7,4,10
9,15,4,9,6,10,11,15,5,5,5,15,5,14
3,13,4,3,15,14,10,10,1,6,2,10,2,10
9,5,4,8,8,8,9,13,5,13,13,13,12,8
