14
1,5,7,5,5,5,5,7,5,7,5,5,5,4
3,6,11,5,5,4,1,15,5,13,5,7,5,4
8,11,13,5,5,6,1,13,5,5,7,12,1,6
2,11,5,7,5,13,5,6,3,7,13,5,5,12
10,11,5,13,5,5,5,13,14,11,6,3,7,4
11,13,5,7,5,5,5,4,10,10,11,12,9,6
11,5,5,15,5,5,7,6,10,10,10,2,3,14
9,7,5,13,5,6,9,12,10,10,10,10,10,10
3,15,5,5,6,11,5,7,13,12,9,14,8,10
10,10,1,7,14,11,6,11,7,6,3,13,6,10
10,10,3,12,10,8,8,8,8,11,14,3,14,10
10,10,10,3,13,7,6,2,2,10,8,8,10,10
11,15,13,12,1,14,9,15,14,10,3,5,13,12
8,8,1,5,5,13,5,12,8,8,9,5,5,4
