14
1,6,2,3,7,7,6,1,7,7,6,3,6,2
3,14,10,11,14,10,10,1,12,10,8,10,11,12
10,10,11,14,10,10,11,7,6,9,7,14,11,6
10,10,10,10,10,11,14,10,8,3,12,10,8,10
10,9,13,14,10,10,10,10,2,11,4,10,2,10
10,3,6,10,11,14,11,13,15,13,5,13,14,10
9,14,8,10,10,10,11,6,10,2,1,5,15,12
2,11,7,12,10,10,9,12,10,11,7,7,13,4
10,8,9,7,12,9,7,7,14,8,10,9,5,4
11,7,5,13,7,5,13,14,9,5,13,5,5,6
10,10,3,7,15,7,5,13,5,5,5,7,5,14
10,10,10,10,10,10,2,2,3,7,5,12,1,12
10,11,12,10,9,13,13,15,13,13,5,7,5,6
9,13,5,13,5,5,5,13,5,5,5,13,5,12
