14
1,7,7,4,3,5,7,5,5,5,7,6,2,2
2,10,10,3,14,3,15,7,7,5,12,9,13,14
10,10,11,12,11,14,8,9,13,5,5,5,4,10
11,12,9,4,9,14,1,7,5,5,5,5,4,10
9,7,5,7,5,13,7,13,5,7,5,5,5,12
3,14,2,11,5,4,9,5,7,13,7,5,5,4
10,9,13,15,5,4,3,6,9,7,15,5,5,6
10,1,7,13,5,4,9,13,5,14,11,7,6,10
10,3,15,6,3,7,5,7,7,14,10,10,10,10
10,10,11,15,14,11,4,10,11,14,10,10,10,10
11,14,10,8,10,11,4,10,10,10,11,14,10,10
10,10,10,3,13,13,7,14,10,10,10,11,15,14
10,10,10,11,6,1,14,10,10,11,14,10,10,10
9,13,12,8,8,1,12,9,12,8,9,12,8,8
