14
1,7,5,5,5,7,5,7,5,5,7,5,5,4
3,13,5,5,4,11,6,10,2,3,13,5,4,2
9,7,4,2,2,10,10,10,9,13,5,5,6,10
1,14,3,14,10,11,15,14,3,6,1,5,15,14
1,13,12,11,15,14,10,11,12,11,5,5,12,8
3,5,5,14,8,8,8,8,3,13,5,5,7,4
11,5,5,13,5,7,7,6,11,5,7,5,13,4
11,5,5,5,7,12,9,12,10,2,11,7,5,6
9,5,7,5,13,7,6,3,14,10,10,10,1,14
3,5,13,7,5,12,11,14,11,15,14,10,3,12
10,2,1,13,7,4,10,8,8,10,11,15,14,2
10,10,3,6,11,6,11,6,2,10,10,10,10,10
10,10,10,10,10,11,14,9,13,12,10,11,14,10
9,13,12,9,12,8,8,1,5,5,13,12,9,12
