14
1,5,5,7,5,5,7,5,5,5,7,5,5,4
3,5,5,13,5,6,11,5,5,5,14,2,3,4
11,5,4,1,5,14,10,1,7,5,12,10,9,6
11,7,7,5,7,13,14,3,13,5,5,14,2,10
8,8,10,3,13,4,8,9,7,5,6,9,13,12
1,5,12,11,5,6,3,5,14,2,11,5,7,6
3,5,7,13,7,14,11,6,10,11,14,3,12,10
11,4,9,6,8,8,9,12,10,10,10,10,2,10
11,7,5,13,7,7,5,6,11,14,11,14,10,10
10,10,1,5,12,9,6,11,14,10,10,10,10,10
10,9,5,6,3,6,9,12,9,15,14,11,15,14
10,2,2,10,8,10,1,7,6,10,10,10,10,10
10,9,13,14,3,12,1,14,9,12,10,11,14,10
9,5,5,13,13,4,1,13,5,4,9,12,8,8
