14
1,7,7,6,1,5,7,7,7,5,5,5,5,6
3,14,10,10,3,5,14,10,9,5,7,5,5,14
10,10,10,11,14,1,14,11,5,7,13,5,5,14
8,10,10,10,10,3,12,11,7,13,5,5,7,12
1,15,14,10,8,9,4,10,9,7,5,5,15,6
3,14,9,13,5,5,5,13,5,13,7,6,10,10
9,13,5,7,5,4,3,6,3,5,12,8,8,10
1,7,7,15,5,6,11,12,10,2,1,7,7,14
3,13,12,9,4,9,15,5,14,11,5,14,10,10
10,2,3,5,5,5,15,4,11,13,6,10,10,10
9,14,10,1,5,7,13,4,10,3,12,10,10,10
1,14,9,7,5,13,5,6,8,9,6,10,11,14
1,12,1,15,5,6,2,10,2,3,14,11,14,10
1,5,5,13,5,13,13,13,13,12,9,12,8,8
