14
1,6,1,7,5,5,5,7,5,6,3,5,7,6
2,11,5,13,5,7,5,13,4,9,14,1,12,8
11,15,5,5,5,15,4,3,4,2,11,6,3,6
8,10,1,7,7,13,5,13,4,11,14,10,10,10
1,14,1,13,15,5,5,5,4,10,8,9,14,8
3,15,5,5,13,5,5,5,6,11,6,3,15,4
10,9,5,7,5,4,3,6,11,14,11,14,9,6
11,5,7,13,5,4,9,14,9,14,10,11,7,12
10,3,14,3,4,2,2,11,7,14,10,10,9,6
10,10,11,13,5,14,11,14,10,10,10,10,1,14
10,10,8,3,5,13,12,11,14,10,10,8,3,12
10,10,2,11,5,5,4,10,11,15,14,3,15,4
10,11,13,13,5,7,5,14,10,10,10,8,9,6
9,12,1,5,5,13,4,8,8,8,9,5,5,12
