14
1,7,5,5,6,2,2,2,3,7,4,2,2,2
1,13,7,4,11,13,12,10,10,11,4,11,15,14
1,5,13,6,11,6,3,14,10,9,5,14,8,8
2,2,2,11,14,10,10,11,15,5,5,15,5,4
10,10,11,14,8,11,12,8,9,5,7,13,5,4
11,14,10,10,3,15,7,5,7,7,13,5,5,6
10,10,10,9,14,8,11,6,10,10,3,5,7,12
10,11,14,1,14,2,9,12,10,10,10,3,13,4
10,11,15,7,13,13,5,4,10,10,10,11,5,4
11,12,9,15,5,4,3,6,10,11,15,13,7,4
9,5,5,15,5,6,10,10,11,14,10,1,13,6
3,5,5,13,5,14,10,11,15,13,12,1,5,14
11,6,2,2,3,14,10,10,11,5,5,5,5,12
8,9,13,13,12,9,12,9,13,5,5,5,5,4
