14
1,6,3,4,3,6,3,6,2,3,4,3,5,4
1,15,13,5,14,11,14,8,11,13,5,15,5,4
3,12,1,5,12,10,11,5,13,5,7,13,6,2
11,5,5,7,7,12,10,1,6,2,11,7,15,14
9,7,4,8,11,4,11,7,15,15,14,10,11,14
2,10,2,3,12,3,12,8,10,8,8,11,14,10
10,11,14,9,6,10,3,6,10,3,6,10,10,10
9,12,10,3,12,10,11,12,10,10,11,14,10,10
3,5,13,15,5,13,13,7,15,14,10,8,10,8
9,6,3,13,5,4,2,10,10,8,11,5,13,4
3,12,9,7,5,4,11,14,9,5,13,7,7,6
11,6,1,13,7,4,8,11,5,5,5,14,10,10
10,9,5,7,13,4,3,12,3,5,5,14,8,8
9,5,5,13,5,5,13,4,9,5,5,13,5,4
