14
1,7,6,2,2,2,2,2,1,5,5,7,5,4
3,15,14,9,15,15,15,15,7,6,2,11,6,2
10,10,11,5,14,8,8,8,8,11,13,14,11,14
8,10,11,5,14,3,5,7,5,13,4,10,10,10
3,14,10,2,11,14,1,13,5,7,4,10,10,10
8,10,8,9,12,10,3,5,5,15,7,14,10,10
3,13,6,2,2,10,11,6,2,11,14,10,10,10
9,6,10,11,14,10,9,12,10,10,10,10,11,12
2,11,15,14,11,13,5,5,15,12,11,14,11,4
11,14,9,14,9,5,7,5,13,6,10,11,14,2
10,10,1,14,3,5,15,5,5,12,10,10,10,10
10,8,1,13,13,6,9,6,2,2,10,10,9,14
10,1,5,5,7,13,6,10,10,11,15,15,6,10
9,5,5,5,13,4,9,13,13,12,8,8,8,8
