14
1,7,5,6,1,5,7,5,7,5,5,5,7,4
1,12,3,13,5,5,15,4,11,5,5,5,15,4
3,7,13,5,5,5,13,7,15,5,5,5,15,4
11,13,5,5,5,5,5,14,11,7,5,5,13,4
9,5,5,7,5,4,1,12,11,14,2,2,3,6
2,3,5,13,5,7,5,4,10,10,11,13,14,8
11,12,3,5,5,12,3,6,8,11,15,7,13,6
9,5,15,5,5,6,9,14,2,10,10,11,6,10
1,5,15,5,4,10,2,10,10,10,10,10,11,14
2,2,10,3,5,14,10,11,14,10,10,10,10,10
10,10,10,9,6,10,10,10,11,15,14,11,14,10
11,14,10,3,14,10,11,14,10,10,11,12,10,10
8,9,15,12,8,9,12,8,10,10,9,4,9,14
1,5,13,5,5,5,5,5,12,8,1,5,5,12
