14
1,5,6,3,5,7,5,5,5,7,5,5,5,4
2,3,12,10,3,14,3,6,3,13,5,5,5,6
11,13,6,11,14,9,12,9,15,5,5,5,7,12
10,3,13,12,9,6,1,5,15,5,5,7,13,4
10,11,7,5,6,11,6,3,15,6,2,11,7,4
10,10,10,1,14,10,9,12,10,9,13,14,9,4
10,10,10,1,14,10,3,6,11,6,3,15,6,2
11,12,8,1,13,14,9,14,10,10,10,8,11,12
9,6,3,7,7,13,6,10,10,10,10,1,15,6
3,13,12,10,10,2,10,10,10,10,10,3,14,10
11,5,7,14,10,10,11,14,10,11,14,10,10,10
10,1,12,10,10,10,8,9,13,14,11,14,8,10
9,5,6,10,11,15,5,7,5,12,10,10,3,14
1,5,12,9,12,8,1,13,5,4,9,13,12,8
