14
1,5,7,7,7,5,5,5,5,6,2,3,5,6
2,3,12,9,14,1,5,5,7,13,13,13,6,10
9,13,6,1,15,5,5,5,13,6,3,7,15,14
1,5,14,1,15,7,6,3,5,15,12,8,10,10
2,3,14,3,12,8,9,15,6,10,1,6,10,10
11,14,10,11,5,7,4,8,10,8,1,13,14,10
10,8,10,8,1,13,7,6,10,3,6,3,14,10
9,6,11,7,6,2,9,12,10,10,9,12,11,12
3,14,10,10,10,10,3,7,14,10,3,5,13,4
10,10,10,11,15,15,14,10,11,14,10,2,1,6
11,15,12,10,10,9,15,15,12,11,13,12,3,12
10,10,2,10,9,6,10,10,1,13,7,5,14,2
10,11,14,10,3,14,10,10,1,5,13,6,10,10
8,8,8,8,8,8,8,8,1,5,5,12,9,12
