14
1,7,6,2,3,5,5,5,7,5,7,5,5,4
1,14,11,15,13,5,5,6,10,2,9,7,5,4
3,14,10,10,1,6,1,14,11,15,5,13,5,4
10,11,14,8,1,13,7,12,11,13,7,5,5,4
11,14,10,1,5,5,15,5,14,3,15,5,6,2
10,10,11,5,7,5,13,5,14,10,11,7,14,10
10,8,9,4,9,7,7,6,11,12,10,10,10,10
10,1,5,7,5,12,9,12,10,1,12,10,10,10
11,5,7,15,5,5,5,5,15,6,3,14,11,14
10,3,15,13,5,5,7,4,10,10,10,8,9,14
10,10,11,5,5,5,15,4,10,10,10,2,1,14
10,10,11,7,6,3,15,6,10,11,15,12,3,12
11,14,8,10,9,12,8,10,8,10,10,2,9,6
8,9,5,13,5,5,5,13,5,12,9,13,5,12
