14
1,7,6,1,7,5,7,6,3,5,7,5,5,4
2,10,10,2,10,2,8,11,13,5,13,6,1,6
11,15,14,10,10,10,1,13,7,7,5,15,5,14
10,10,9,13,15,14,1,7,12,9,4,10,1,14
10,10,2,2,10,10,1,13,5,7,5,14,1,14
10,10,10,10,10,11,5,5,5,13,4,10,3,14
10,11,14,11,15,15,7,6,2,3,6,9,14,10
10,8,11,12,8,10,9,12,10,10,11,7,14,10
11,7,15,5,5,13,5,5,13,14,8,8,8,10
10,9,13,7,5,5,6,1,7,13,5,5,4,10
9,5,6,9,7,4,10,3,13,5,7,5,4,10
1,7,12,1,13,6,11,13,5,7,13,5,6,10
1,15,5,5,7,13,13,7,5,13,5,4,11,12
1,13,4,1,13,4,1,13,5,5,5,5,13,4
