14
1,5,7,5,5,5,7,7,7,7,6,2,3,6
2,3,15,5,5,5,13,14,10,10,10,11,12,8
10,11,13,5,5,7,4,10,10,10,11,14,3,4
11,15,5,5,5,13,4,11,15,14,10,10,9,6
10,11,5,5,5,5,6,10,10,10,8,11,5,12
10,9,5,5,5,7,12,8,10,9,5,13,7,4
9,6,2,2,2,10,3,6,10,1,7,5,13,4
3,13,13,13,13,14,9,13,14,3,12,3,6,2
10,2,3,6,1,15,5,5,15,13,6,10,11,14
11,14,10,11,7,12,1,5,14,1,14,10,10,10
10,10,10,8,11,5,5,4,11,5,15,14,8,10
10,10,10,3,13,5,5,7,12,1,12,9,6,10
11,14,10,9,5,6,3,13,7,7,7,7,15,14
8,9,12,1,5,12,8,1,12,8,8,8,8,8
