14
1,5,5,5,7,4,2,3,6,3,7,5,7,4
2,3,7,5,13,5,13,15,15,14,10,1,15,4
9,15,13,5,5,6,3,14,10,8,8,1,13,6
3,13,5,5,7,13,14,10,11,5,5,5,5,14
9,5,5,7,15,6,10,10,10,2,1,5,5,14
3,5,5,14,11,14,8,8,10,10,3,5,5,12
11,5,4,11,14,10,3,6,10,10,9,5,5,6
9,7,5,14,10,11,13,12,11,14,3,5,5,12
2,10,2,10,10,11,5,7,12,9,13,7,5,4
11,14,10,10,10,9,4,9,7,5,5,15,5,4
10,10,10,8,9,5,7,5,15,5,5,13,5,6
10,9,13,5,7,5,15,5,15,5,5,5,7,12
11,4,1,7,13,5,12,1,13,7,5,7,15,4
9,5,5,13,5,5,5,5,5,13,5,12,9,4
