14
1,5,7,5,5,7,5,5,6,3,7,7,5,6
3,5,13,7,5,13,5,5,15,14,10,9,6,10
10,3,5,15,5,5,5,5,12,10,10,1,14,10
11,14,3,13,5,7,4,2,1,14,8,3,12,8
10,10,11,6,1,13,4,9,7,13,5,13,5,6
10,11,14,10,3,7,5,7,15,7,5,5,5,12
10,10,10,10,10,8,3,14,10,11,7,5,4,2
10,8,11,14,10,2,9,12,11,14,9,7,5,14
10,3,14,11,14,10,2,3,14,10,1,15,4,10
11,12,8,8,9,14,9,14,8,10,3,13,4,8
11,4,1,5,7,13,6,11,6,10,10,3,7,6
9,5,5,5,13,6,10,10,11,15,15,12,8,10
3,6,2,3,7,14,10,10,10,10,9,7,4,8
8,9,13,12,8,9,13,12,8,8,1,13,5,4
