14
1,6,2,1,5,6,3,5,5,7,5,5,5,6
2,11,15,5,5,13,13,6,2,10,1,7,5,12
10,10,11,5,5,7,5,12,9,12,3,12,3,6
10,10,11,5,7,13,5,5,5,7,15,4,10,10
10,10,10,2,11,5,5,7,5,12,9,5,12,10
11,15,14,10,11,5,5,13,7,4,3,5,5,12
9,12,9,15,14,2,3,6,10,1,13,5,7,4
3,7,7,14,11,15,13,12,11,5,5,5,15,4
10,10,10,10,10,10,1,7,12,2,3,5,14,2
10,10,8,11,12,11,5,13,6,9,15,4,8,10
10,10,2,9,6,8,1,5,14,1,13,5,5,14
10,10,11,5,13,5,7,5,13,5,5,7,7,14
10,11,13,6,1,7,14,1,5,7,5,12,10,10
9,13,5,13,5,12,9,5,5,13,5,5,12,8
