14
1,5,7,5,7,6,3,7,5,5,5,5,7,6
1,5,13,6,10,10,11,14,3,5,5,7,13,12
2,2,3,14,10,10,10,10,11,7,6,9,5,6
10,11,14,10,8,11,12,10,8,10,10,1,5,14
10,8,11,14,3,14,2,11,7,15,14,3,6,10
10,2,10,11,12,11,14,8,10,10,10,10,11,14
11,15,14,10,2,10,11,6,10,10,11,14,10,10
11,12,8,8,9,14,9,12,10,10,11,14,10,10
9,5,5,5,7,15,5,5,15,14,10,10,10,10
1,5,5,7,13,15,5,5,12,8,10,10,8,10
3,5,5,13,4,11,7,5,5,5,12,10,3,14
11,5,5,5,5,15,13,7,5,5,4,11,14,10
11,5,6,2,2,11,6,10,2,2,3,12,11,12
9,4,9,13,13,12,9,13,13,13,13,5,13,4
