14
1,5,7,5,5,5,5,7,5,5,5,5,5,6
1,5,13,7,7,5,5,13,5,7,5,5,5,14
1,5,5,15,13,5,6,1,7,13,4,3,5,12
3,7,7,13,5,5,12,1,14,2,3,13,7,6
10,11,15,7,5,5,7,5,13,15,15,6,10,10
10,10,10,10,3,7,15,5,7,14,10,11,14,10
8,8,10,10,8,10,11,6,10,10,10,10,10,10
2,1,14,10,2,10,9,12,11,14,10,10,10,10
11,5,12,9,15,15,6,2,10,11,14,10,9,14
10,2,3,6,10,10,11,15,12,8,9,12,1,14
10,10,10,10,10,10,10,9,5,6,2,1,7,12
11,15,14,11,15,14,10,3,7,12,10,1,15,4
10,8,8,10,8,8,10,8,9,5,14,2,11,6
8,1,5,12,1,5,13,5,5,5,13,13,12,8
