14
1,7,6,2,2,3,7,5,7,5,5,5,6,2
3,12,9,13,12,10,10,2,11,7,6,3,14,10
9,5,5,5,6,10,10,10,10,10,8,10,8,10
1,5,5,7,12,11,14,10,10,10,1,15,5,14
1,5,5,14,3,14,10,10,11,14,1,15,4,8
1,5,5,15,13,12,9,15,14,11,7,14,2,2
1,7,5,13,4,2,3,14,8,10,8,9,13,14
1,13,7,5,5,12,9,12,3,13,5,5,7,12
2,2,11,7,7,7,7,5,13,5,4,2,10,2
10,11,14,8,8,11,15,7,4,3,4,11,15,14
10,10,10,2,3,12,8,11,5,13,6,10,11,14
11,14,10,10,10,3,7,14,2,1,14,11,14,10
8,10,10,9,13,14,8,9,14,3,13,14,10,10
1,13,13,5,5,13,5,5,13,13,5,12,8,8
