14
1,6,2,2,2,2,1,6,1,5,5,5,6,2
1,15,14,10,10,11,5,15,5,5,5,7,14,10
3,12,11,14,10,11,7,13,5,5,5,12,10,10
11,4,8,10,11,12,11,5,5,5,6,2,10,10
11,5,4,9,12,3,13,5,5,7,13,14,11,14
9,5,5,7,7,13,5,5,5,15,5,13,14,10
1,7,5,14,9,6,3,6,2,11,5,6,10,10
1,13,4,11,7,14,11,12,11,13,6,9,12,8
3,5,5,12,10,10,11,6,11,6,11,6,3,6
10,2,2,2,11,15,12,9,12,9,14,9,14,10
11,14,11,14,10,11,5,5,5,5,14,1,14,10
10,11,14,11,14,11,7,6,3,5,14,3,12,10
8,8,8,10,8,8,8,11,12,3,12,11,4,10
1,5,5,13,5,5,5,13,5,13,5,13,5,12
