14
1,6,3,7,7,6,3,7,5,5,5,5,7,6
2,11,14,10,10,10,10,11,5,5,5,5,14,8
9,14,10,11,14,11,14,9,5,7,5,5,14,2
3,12,8,10,10,10,10,1,5,13,7,5,14,10
10,1,6,10,11,15,15,5,7,5,13,7,12,10
9,7,13,12,10,10,8,1,15,5,7,15,7,14
3,13,7,7,14,10,3,6,10,1,14,11,14,10
10,1,14,8,8,9,13,12,10,3,12,10,10,10
11,7,15,5,5,5,5,6,10,11,4,10,11,14
10,10,10,1,5,6,2,10,11,15,6,10,10,10
8,8,10,1,7,12,11,14,10,8,11,12,8,8
3,5,12,1,15,4,10,10,10,3,15,5,5,4
10,2,2,3,14,2,10,11,12,8,11,5,5,4
9,13,13,12,9,13,13,13,5,5,13,5,5,4
