14
1,5,5,7,5,5,6,2,3,5,5,5,5,6
3,7,5,13,5,4,10,11,15,5,5,7,4,10
11,13,5,5,5,7,14,10,9,4,1,15,4,10
10,1,7,5,5,12,11,12,1,5,5,15,4,10
10,1,15,5,7,4,10,2,3,5,5,13,7,14
11,6,10,3,13,4,11,13,12,1,5,7,12,10
10,11,12,10,3,6,11,6,1,5,7,13,4,10
10,11,4,10,10,10,9,12,1,5,13,5,6,10
10,10,2,11,14,11,7,5,5,5,7,5,14,10
10,11,12,10,10,8,10,3,5,7,13,4,8,8
11,15,7,14,11,6,11,14,3,13,7,5,5,4
8,10,8,8,10,11,14,9,14,1,13,5,7,4
2,9,6,2,10,10,8,1,13,5,5,7,13,6
9,5,13,13,12,9,4,1,5,5,5,13,5,12
