14
1,7,6,3,5,5,7,5,5,5,5,5,7,4
3,14,11,14,1,5,15,5,4,2,2,3,12,2
11,14,8,11,7,5,13,7,5,12,10,9,6,10
10,10,2,10,10,3,5,13,5,7,12,2,11,14
10,9,14,10,11,13,6,3,5,13,4,10,10,10
10,3,15,14,10,3,13,13,7,7,5,13,12,10
10,10,11,15,14,10,3,6,10,8,1,7,5,12
10,11,14,10,10,10,9,13,14,2,1,13,7,4
10,10,10,10,10,10,3,6,11,14,1,7,13,4
11,14,10,11,13,13,12,9,14,10,2,9,5,6
10,10,9,13,5,5,6,3,14,10,11,6,2,10
10,9,7,5,5,5,12,10,8,9,12,10,10,10
10,1,13,5,7,7,4,9,7,5,4,11,14,10
9,5,5,4,8,9,5,5,13,5,4,8,9,12
