14
1,7,5,4,3,5,5,5,5,5,7,5,4,2
2,10,1,6,10,3,5,5,7,5,13,5,6,10
11,15,5,14,9,15,4,2,11,5,5,5,14,10
10,10,2,11,7,14,2,10,10,2,1,7,12,10
8,10,9,14,10,10,10,10,11,12,1,13,5,14
2,10,2,11,14,11,13,13,13,5,6,2,3,12
11,12,10,10,10,10,3,6,1,5,14,10,11,4
10,3,15,14,11,14,9,13,7,5,13,15,13,4
10,10,10,10,10,11,6,2,11,6,2,11,6,2
9,14,10,10,8,8,10,10,10,11,13,12,9,12
3,15,14,11,5,5,14,11,15,13,5,7,5,4
10,11,12,10,1,7,13,14,11,5,7,13,5,4
10,11,5,12,3,13,4,11,14,3,15,7,7,6
8,9,5,5,13,5,5,12,9,12,8,8,8,8
