14
1,5,5,7,5,5,7,7,5,5,7,5,5,6
3,5,7,13,5,5,14,10,3,5,15,5,5,12
10,3,15,5,5,5,12,10,10,2,11,6,3,6
10,10,10,1,7,7,6,11,14,10,10,10,10,10
11,14,10,1,14,8,11,14,9,13,12,10,10,10
10,10,10,3,15,6,8,9,7,6,2,11,13,14
10,9,15,12,8,8,3,6,11,14,10,9,6,10
9,5,15,5,7,6,9,14,10,10,10,1,14,10
3,5,13,4,10,10,3,14,10,11,14,3,14,10
9,5,5,6,8,9,14,10,10,10,11,14,11,12
3,5,5,13,7,5,12,9,12,10,10,10,10,2
11,5,5,7,12,3,5,7,5,13,12,10,11,12
10,1,5,13,4,10,1,15,5,5,5,12,11,4
9,5,5,5,5,12,1,13,5,5,5,4,9,4
