14
1,5,7,5,5,5,5,7,5,5,5,5,7,6
1,5,13,5,7,6,2,10,1,7,5,5,13,14
3,7,6,3,15,14,10,11,5,15,5,5,5,12
10,8,9,12,10,9,12,10,1,13,6,2,2,2
11,5,5,5,15,5,7,14,3,5,13,13,13,14
10,1,5,5,15,5,12,8,10,2,3,5,7,12
10,1,5,5,13,7,7,6,10,10,10,2,11,4
10,1,5,5,7,12,9,12,11,13,15,14,10,2
10,3,7,7,14,2,3,7,14,2,8,10,9,12
10,11,14,10,10,10,11,15,14,10,1,13,7,4
10,10,10,10,10,10,10,10,10,10,3,5,13,4
11,14,11,15,15,14,10,10,10,11,13,5,7,4
8,10,10,10,10,9,12,10,9,14,3,7,13,4
1,12,8,8,9,5,4,8,1,13,12,9,5,4
