14
1,7,5,5,5,7,5,5,5,5,5,6,2,2
3,15,7,7,4,9,7,4,2,2,2,10,10,10
10,8,8,9,4,1,13,6,11,15,14,9,15,12
10,2,2,3,6,1,6,10,10,8,11,5,15,4
11,14,10,10,11,5,13,15,15,6,10,2,10,2
10,9,14,10,10,3,7,12,10,11,14,11,14,10
11,4,9,14,11,14,11,6,8,10,10,10,9,14
9,5,6,8,10,8,9,12,2,11,15,15,6,10
3,7,14,1,15,5,5,4,11,14,8,10,9,14
10,10,10,1,13,5,7,4,10,10,3,12,1,12
10,10,11,7,7,6,11,7,14,10,11,6,2,2
10,10,10,10,10,11,14,10,10,9,14,10,10,10
11,15,15,12,10,8,10,10,10,1,14,9,15,14
8,8,9,4,8,1,12,9,12,1,13,4,8,8
