14
1,7,5,6,1,7,7,5,7,7,5,5,7,4
2,10,1,15,5,12,9,6,11,14,1,6,10,2
10,11,5,13,7,5,5,12,10,10,3,12,10,10
10,10,1,7,12,1,5,5,14,10,9,5,13,14
10,10,3,13,6,1,5,7,12,10,1,5,7,12
11,14,11,6,10,3,5,13,6,9,5,5,13,6
9,14,10,10,10,10,3,7,14,3,5,5,7,12
3,13,14,11,15,14,9,12,11,12,1,7,13,4
10,3,14,10,10,11,5,6,11,7,7,15,5,6
10,10,11,14,10,10,3,13,14,10,10,10,1,14
10,8,10,8,11,12,9,4,10,8,8,8,3,12
11,7,13,5,13,5,5,5,13,5,7,5,13,6
10,9,5,5,5,7,5,4,3,5,13,5,5,14
9,5,5,5,5,13,5,5,13,5,5,5,5,12
