14
1,6,2,3,4,3,7,6,1,7,5,5,5,6
1,13,13,15,4,8,8,11,5,13,5,7,5,12
3,5,5,15,5,5,5,13,6,2,1,14,3,6
10,2,2,9,7,5,7,5,12,11,5,15,12,8
10,10,11,7,12,1,15,4,3,14,1,13,5,4
10,10,10,11,6,3,13,7,14,10,2,2,3,6
11,15,14,10,10,10,3,14,10,10,10,10,10,10
8,8,8,10,11,14,9,12,10,10,10,10,10,8
1,5,5,14,8,9,7,5,14,11,15,14,11,6
2,3,6,11,7,5,12,1,14,10,10,11,14,10
10,10,9,14,9,5,6,2,10,11,13,13,12,10
10,10,1,15,5,5,13,14,11,13,5,7,5,14
11,13,7,13,5,6,2,9,13,7,5,13,6,10
8,1,13,5,4,9,12,1,5,13,5,5,12,8
