14
1,7,5,5,5,7,4,2,3,5,5,5,7,4
1,15,5,5,5,15,4,10,9,5,7,5,13,4
1,15,5,6,1,13,6,11,5,5,13,5,5,6
3,14,1,15,5,5,13,14,1,7,5,5,7,14
10,11,7,13,7,5,5,12,2,10,1,5,14,10
11,14,10,2,10,3,5,5,15,12,1,5,12,10
10,10,11,13,13,12,3,6,9,5,5,5,7,14
10,10,9,6,2,2,9,14,3,5,5,5,12,10
10,11,5,15,13,13,5,13,15,5,5,5,6,10
10,11,6,9,7,4,2,1,15,7,6,2,9,14
10,10,10,1,15,4,11,5,14,8,9,15,5,12
10,10,10,1,13,7,14,1,15,5,5,12,1,6
11,12,10,1,6,10,10,1,15,5,5,5,7,14
9,4,9,5,13,12,8,1,13,5,5,4,8,8
