14
1,7,7,7,6,3,7,5,5,7,5,5,7,4
2,10,10,10,10,10,10,1,7,12,3,7,15,4
10,10,8,10,8,8,11,5,13,6,10,10,9,6
10,10,2,10,2,3,12,3,5,12,10,10,3,12
11,15,15,13,13,15,4,11,5,4,10,10,9,6
10,8,10,1,5,13,4,9,7,5,14,8,3,12
9,5,15,5,7,7,7,6,11,7,14,2,11,4
2,2,9,6,10,10,9,12,10,10,10,11,13,4
9,13,7,12,8,9,7,5,14,10,11,15,6,2
3,5,13,6,3,6,9,6,8,10,10,11,14,10
9,5,6,9,12,10,3,15,7,12,10,10,10,10
3,5,12,1,6,10,10,10,10,3,14,10,10,10
11,5,4,1,13,15,12,8,11,12,8,10,11,14
9,5,5,5,5,13,5,5,13,5,5,12,8,8
