14
1,7,5,5,5,5,5,7,5,7,5,5,7,4
3,15,5,5,7,5,4,8,1,13,4,3,15,6
10,9,7,4,10,3,6,3,7,7,7,15,15,14
8,1,15,5,13,14,11,14,10,10,10,10,10,10
1,5,13,5,6,10,10,10,8,8,10,10,10,10
3,5,5,5,14,8,8,11,7,6,10,10,10,10
10,2,1,7,13,4,3,14,10,11,14,8,10,10
10,11,5,13,7,6,9,12,8,10,9,7,14,10
11,12,1,5,12,10,3,7,5,12,1,14,9,12
11,5,4,3,4,10,10,11,7,7,5,13,5,4
10,1,6,10,2,11,12,8,9,12,2,2,2,2
11,5,13,13,12,9,5,5,5,6,10,10,10,10
9,5,5,7,5,5,5,5,5,15,15,15,15,14
1,5,5,13,5,5,5,5,5,13,12,8,8,8
