14
1,6,1,5,7,5,6,2,2,2,2,2,3,6
3,14,1,6,9,6,10,10,11,14,9,13,12,10
10,8,3,13,7,14,11,14,10,11,5,5,5,12
10,3,14,2,10,8,8,11,13,12,3,5,5,4
10,10,9,14,10,3,4,9,6,2,10,3,5,6
9,15,5,12,9,15,5,5,15,12,11,14,3,12
3,14,2,3,6,10,3,6,9,7,12,10,9,6
11,14,10,10,11,14,9,13,7,14,3,14,1,14
10,10,11,12,10,11,7,5,12,9,12,10,2,10
10,10,10,3,12,9,15,5,5,5,4,10,9,14
10,10,10,9,5,7,13,7,7,7,7,14,2,10
10,10,10,1,5,13,6,8,8,8,10,10,10,10
10,11,14,2,2,3,14,1,7,5,12,9,15,14
8,8,9,13,13,12,8,1,13,5,4,1,12,8
