14
1,7,5,5,5,5,5,7,5,5,5,5,6,2
2,11,5,5,7,5,5,13,5,5,5,6,10,10
11,13,5,5,13,7,7,5,7,5,5,12,11,14
11,7,5,5,7,12,9,6,11,6,1,6,10,10
10,9,5,7,14,1,5,13,14,9,5,13,14,10
10,3,5,14,10,3,7,5,13,7,5,4,10,10
10,10,2,10,9,14,11,6,2,11,5,6,10,10
10,10,10,10,3,14,9,12,10,10,2,10,10,10
11,14,11,12,10,10,2,2,10,10,10,11,15,14
10,11,13,7,14,10,10,10,11,13,14,10,8,10
10,10,2,10,10,11,14,11,14,3,14,10,2,10
10,11,13,13,14,8,9,12,10,8,9,13,14,10
10,11,6,2,10,3,6,3,13,7,5,5,13,14
9,12,9,13,13,12,9,13,4,9,5,5,4,8
