14
1,7,6,2,3,6,2,1,7,5,7,5,5,4
3,14,10,11,14,10,10,1,14,3,14,3,5,4
10,8,9,14,8,9,15,5,12,10,10,10,3,6
11,5,7,13,6,2,9,5,6,11,14,10,8,10
11,6,10,1,13,14,1,5,14,10,11,14,3,12
10,11,14,1,5,14,1,7,13,14,10,11,14,2
10,10,11,5,5,14,3,14,3,12,9,12,9,14
10,10,10,2,2,10,9,12,11,6,3,5,7,12
11,12,10,9,13,13,7,5,12,11,12,1,13,4
10,2,10,1,7,6,9,6,2,10,3,4,3,6
8,9,13,7,12,11,7,12,11,14,11,4,10,10
3,5,5,13,5,14,9,7,12,9,15,4,8,10
9,5,5,7,5,14,1,14,3,5,13,7,5,12
1,5,5,13,5,12,1,12,9,5,5,13,5,4
