16
1,7,5,5,7,5,5,7,5,4,3,4,2,3,6,2
2,10,1,5,15,5,7,13,5,4,11,5,13,12,10,10
10,10,3,7,13,5,13,7,4,3,15,5,4,2,10,10
10,11,13,14,1,7,5,13,6,10,9,5,7,15,15,14
11,14,1,13,5,15,4,3,13,12,1,7,15,14,8,10
10,10,2,3,5,15,5,13,5,5,7,12,10,10,2,10
11,13,13,13,5,15,7,5,5,6,9,6,10,10,11,14
11,7,5,5,5,12,10,3,6,11,5,12,10,9,12,10
11,15,5,5,5,5,14,9,13,14,3,7,14,1,7,12
10,10,1,7,5,4,11,5,5,13,12,8,9,5,13,6
11,13,5,15,7,4,9,5,5,6,2,2,2,3,7,12
11,6,3,12,11,5,5,7,5,13,13,13,13,12,11,4
10,10,11,4,11,5,7,13,5,7,6,3,4,3,13,6
10,10,9,7,15,4,9,5,6,8,8,9,7,12,3,14
8,10,3,12,9,7,5,4,10,1,5,7,13,4,10,10
1,13,13,4,1,13,5,5,13,5,5,13,5,4,8,8
