16
1,6,1,7,5,5,7,7,5,7,5,6,2,3,7,4
3,12,3,13,4,3,12,8,1,13,4,11,15,14,11,4
9,6,11,5,5,13,5,5,5,5,5,14,8,8,11,4
3,15,13,5,5,7,5,5,7,5,4,9,7,4,10,2
10,9,7,4,2,10,2,3,13,5,5,7,13,6,11,14
10,3,13,5,15,13,13,14,1,6,2,9,6,10,10,10
10,9,7,6,9,7,5,13,5,13,13,7,13,12,10,10
10,3,12,9,5,13,6,3,6,1,7,13,5,4,10,10
10,10,1,7,5,5,13,13,12,3,14,2,3,6,10,10
11,14,1,13,5,5,6,2,1,14,11,15,14,11,14,10
10,9,5,5,7,5,12,10,3,14,10,10,11,14,10,10
10,2,3,5,15,5,4,10,10,8,8,10,8,11,14,10
11,14,8,1,13,7,4,11,14,1,7,13,4,10,10,10
8,9,7,5,5,15,5,12,11,7,15,5,6,11,12,10
3,5,13,5,5,14,2,1,14,10,9,6,9,13,7,14
9,5,5,5,5,13,13,5,12,8,1,12,1,5,12,8
