16
1,7,6,2,2,2,2,3,5,5,5,7,5,5,6,2
2,10,10,11,15,14,11,13,5,7,5,13,7,5,15,14
10,10,10,10,10,10,11,6,3,15,7,6,11,5,14,10
11,12,9,12,8,11,12,9,12,10,11,13,13,4,10,10
9,6,3,5,5,13,7,5,5,12,8,1,5,7,12,10
3,14,9,7,6,3,15,5,5,5,4,3,5,12,3,14
10,9,7,14,10,11,15,5,7,7,6,9,5,6,10,10
11,4,8,10,10,10,10,3,14,10,10,1,7,13,13,12
11,6,1,14,10,10,10,9,12,11,14,3,12,2,3,4
10,10,3,15,15,14,10,2,3,12,10,10,2,11,15,4
10,9,14,8,11,14,10,11,13,4,11,15,13,14,9,6
10,3,15,7,14,10,11,15,6,2,10,9,4,8,1,14
10,10,10,10,10,11,12,10,9,14,9,5,5,6,3,14
11,12,8,10,8,11,4,10,2,11,5,5,5,13,14,10
10,1,7,12,1,15,5,15,15,14,3,7,7,4,11,14
8,1,13,4,1,13,4,8,8,9,12,8,9,5,12,8
