16
1,5,7,7,7,7,5,4,1,7,6,2,3,7,6,2
3,7,12,10,10,11,7,6,1,14,11,13,12,8,11,12
11,15,4,10,8,10,8,11,7,14,9,6,3,5,14,2
10,9,6,10,1,13,7,14,10,8,1,13,13,6,11,14
10,1,12,10,1,7,12,10,9,5,7,6,3,15,12,10
10,2,1,15,5,15,4,11,5,5,12,9,12,11,4,10
10,9,5,15,5,13,6,9,5,7,5,5,5,13,6,10
10,1,5,13,5,7,13,7,6,11,5,7,5,5,12,10
10,3,5,5,5,15,4,9,12,11,5,13,5,5,6,10
10,9,5,7,5,13,7,5,5,13,7,5,5,5,13,14
11,7,7,15,6,2,9,7,5,5,13,7,4,1,6,10
10,10,10,10,11,13,5,15,5,5,7,15,7,5,14,10
11,14,10,10,10,2,2,11,6,3,12,8,8,1,15,14
10,9,15,14,11,14,10,10,11,15,7,5,5,5,12,10
11,4,10,10,10,10,10,10,8,9,15,4,3,5,6,10
9,4,8,9,12,9,13,12,1,5,13,5,13,4,9,12
