16
1,6,2,3,5,5,5,7,5,7,7,5,5,5,7,4
2,11,13,15,5,5,5,14,2,10,9,7,4,1,15,4
11,14,1,15,5,5,7,12,10,10,3,14,2,3,13,6
10,8,3,13,7,5,13,5,14,10,10,10,10,10,1,14
10,1,15,5,13,5,7,4,10,10,11,14,10,10,3,12
11,7,14,3,7,5,13,4,9,14,10,11,15,14,9,6
10,10,10,10,10,1,7,5,5,14,10,10,10,8,1,14
10,10,11,14,10,1,15,7,6,11,14,10,11,7,5,14
10,11,14,10,11,7,12,9,12,10,10,10,10,10,3,12
10,10,10,11,14,10,1,7,5,12,11,14,8,11,15,6
9,12,8,10,8,11,5,13,5,4,10,11,5,14,10,10
1,7,5,13,4,9,7,5,5,5,12,8,1,12,8,10
2,10,2,3,7,5,13,5,7,4,1,5,7,5,5,14
10,11,13,14,8,1,7,5,13,4,3,5,13,7,5,12
11,13,5,13,5,7,13,5,5,4,11,7,6,10,2,2
9,5,5,5,5,13,5,5,5,5,12,8,9,13,13,12
