16
1,7,7,7,4,3,4,2,3,7,7,7,5,5,5,4
3,12,8,9,5,14,2,10,10,11,13,15,5,5,7,4
9,5,5,5,6,9,15,15,14,10,3,14,3,5,15,4
3,5,5,5,15,7,13,12,8,8,10,8,10,2,10,2
9,5,7,5,13,13,5,5,6,2,9,5,14,10,11,14
1,5,13,7,5,5,5,7,13,12,3,5,12,11,14,10
3,7,5,13,7,5,5,13,5,6,11,4,3,14,10,10
10,9,5,5,13,6,3,7,6,10,11,5,12,10,10,10
10,2,3,6,2,9,14,9,12,11,15,5,5,12,10,10
11,15,14,9,13,5,15,7,5,14,9,5,5,4,10,10
10,10,10,3,5,5,14,9,6,11,7,5,4,2,11,14
10,10,10,8,3,5,12,1,14,11,13,5,6,11,14,10
10,10,10,1,13,7,6,1,14,10,1,7,13,14,10,10
10,11,14,1,5,14,10,3,12,10,2,10,2,9,15,12
10,10,11,5,5,12,11,13,5,14,10,11,15,5,15,4
9,12,9,5,5,5,13,5,5,12,9,12,8,1,13,4
