16
1,5,5,5,7,5,5,5,5,7,6,1,5,6,2,2
1,5,7,5,12,2,2,3,5,14,10,3,6,11,14,10
1,5,13,7,4,11,13,13,6,8,10,8,11,12,10,10
3,5,5,15,4,11,4,1,13,7,12,2,10,2,11,14
10,1,5,15,6,9,5,5,5,15,7,15,13,12,8,10
10,3,5,12,10,2,3,6,1,14,10,10,2,2,3,12
10,11,7,6,10,10,10,9,5,14,11,15,14,11,13,6
10,10,10,11,15,15,15,7,6,10,10,10,11,15,7,14
11,14,11,12,10,8,8,9,12,11,14,10,10,10,10,10
11,14,10,3,13,5,7,5,5,12,10,8,10,10,10,10
11,15,14,11,4,1,15,5,5,5,15,5,14,10,10,10
10,10,8,9,7,5,13,5,5,5,13,7,14,8,8,10
10,11,5,5,13,7,5,5,5,5,7,12,9,5,6,10
10,10,2,2,3,15,4,3,7,7,14,2,3,6,10,10
10,11,13,13,12,9,5,12,8,8,9,12,8,11,12,10
9,13,5,5,5,5,5,5,5,5,5,4,1,13,5,12
