16
1,7,5,4,1,7,5,7,5,5,5,5,7,5,5,4
1,13,7,4,1,15,5,15,5,7,7,5,15,5,5,4
1,5,15,5,5,15,4,8,1,12,11,5,13,5,7,4
3,5,15,5,5,13,6,3,7,7,13,5,4,1,15,6
11,5,13,7,7,4,10,10,10,9,5,5,5,5,13,14
8,1,7,12,10,2,10,11,15,5,7,5,5,7,5,14
3,6,10,2,11,15,15,12,9,6,9,5,6,11,7,12
10,11,14,11,15,14,10,3,6,10,1,5,15,14,11,6
10,11,14,10,10,10,10,11,12,11,7,7,14,10,10,10
10,10,11,14,10,11,13,13,7,12,10,8,8,10,10,10
11,14,10,9,12,10,2,2,11,6,11,5,6,8,8,8
10,8,9,5,5,15,14,11,14,10,10,2,9,6,2,2
10,3,5,4,3,12,11,14,10,11,14,10,1,15,14,10
11,13,5,7,13,6,10,8,8,10,10,11,6,10,10,10
10,1,7,12,3,14,10,1,7,12,10,10,11,12,11,14
8,1,13,4,8,9,12,1,13,4,9,12,9,4,8,8
