16
1,7,7,7,5,5,5,7,5,5,7,5,5,5,5,4
3,14,10,11,5,5,5,13,6,3,13,5,5,5,5,6
11,14,10,11,7,5,5,5,12,9,6,1,7,4,1,14
10,10,11,15,13,5,5,7,6,3,13,5,13,5,7,12
10,11,14,11,4,1,5,12,10,9,5,5,5,7,13,4
10,10,10,9,5,6,3,7,12,2,1,5,5,15,5,4
10,10,11,7,4,11,14,9,5,14,1,5,7,13,5,4
11,12,8,9,4,10,10,3,6,11,5,5,15,5,5,4
10,3,5,4,2,8,10,11,12,9,7,5,13,5,7,6
10,11,7,7,14,2,10,11,6,3,12,2,3,5,13,12
10,10,10,10,11,14,10,10,10,11,5,14,9,7,5,4
10,10,10,10,10,11,15,14,11,14,2,10,3,15,5,4
11,14,10,10,10,8,10,10,10,11,12,9,12,9,5,6
9,15,14,9,14,1,12,10,10,9,5,6,1,5,5,14
3,12,8,1,13,7,4,8,10,3,5,13,5,5,5,12
9,5,4,1,5,13,4,1,13,13,5,5,5,5,5,4
