16
1,5,5,7,5,5,6,2,1,5,5,6,1,5,5,6
1,7,5,12,1,5,15,13,6,3,5,13,5,5,7,14
3,14,3,5,5,5,15,4,9,15,5,5,7,5,13,14
10,9,15,5,7,5,14,3,5,13,7,5,13,5,6,8
10,3,13,4,11,7,15,14,1,5,15,5,5,5,13,4
10,9,7,4,11,14,10,10,1,5,13,5,7,7,5,6
10,1,15,5,14,10,10,9,5,7,5,5,14,8,1,14
11,6,11,6,10,10,11,7,6,9,5,7,13,5,5,14
10,9,12,10,10,8,10,9,12,3,5,13,5,5,6,10
10,1,5,13,12,1,13,5,5,15,5,5,5,7,12,10
11,6,2,2,2,3,5,7,5,13,4,3,6,11,6,10
10,10,11,14,11,15,5,15,5,5,5,14,11,14,10,10
10,10,10,11,14,11,5,13,5,7,4,10,10,11,14,10
10,10,10,10,10,11,5,5,7,13,4,10,10,10,11,14
10,9,12,8,10,11,7,5,14,1,6,11,14,10,9,14
8,1,5,5,12,8,9,4,9,5,12,8,9,12,1,12
