16
1,6,2,2,3,5,5,5,7,5,7,5,5,5,5,6
3,14,11,15,14,3,7,7,14,3,13,4,3,5,5,12
10,10,8,8,9,12,11,14,11,13,5,7,13,5,7,6
10,11,5,7,5,5,12,8,10,1,5,14,1,7,12,8
10,10,1,13,5,7,4,3,12,3,5,12,1,13,5,6
10,10,3,6,1,13,6,11,4,9,5,6,3,5,5,12
11,13,12,9,7,5,14,9,4,3,5,13,13,5,5,4
10,3,5,5,13,5,14,3,7,14,3,5,5,5,7,4
10,11,7,7,6,1,14,9,12,10,10,2,3,6,11,4
10,10,10,10,8,1,13,6,3,13,14,10,10,11,15,4
11,12,8,11,4,3,5,13,14,3,12,10,8,8,9,6
9,6,2,11,5,13,7,4,8,11,5,14,1,5,5,14
1,13,14,9,5,7,12,1,5,15,4,11,5,5,6,10
3,5,12,1,5,15,5,5,7,13,5,13,5,5,15,14
9,7,4,1,7,13,6,3,15,5,7,5,5,7,12,10
1,13,5,5,13,4,9,12,9,5,13,5,5,13,4,8
