16
1,5,7,5,5,5,7,5,6,2,1,5,6,2,1,6
2,2,10,3,4,2,11,7,13,12,3,5,13,13,5,12
10,10,11,13,6,9,14,9,7,5,14,1,7,4,2,2
10,9,14,1,15,7,14,3,13,4,9,5,13,6,11,14
10,3,13,7,14,11,14,9,7,5,5,5,5,15,14,10
11,13,4,10,10,10,10,3,13,4,3,5,5,14,10,10
10,1,6,10,10,10,11,13,5,7,13,5,5,14,10,8
9,5,14,10,11,14,11,7,6,9,7,5,4,10,11,4
2,3,14,8,8,8,8,9,12,3,13,5,4,10,10,2
11,12,11,6,1,5,7,5,5,13,5,5,4,9,15,12
11,7,14,10,3,7,15,7,7,5,5,5,5,6,10,2
10,10,10,10,10,10,8,10,9,5,5,5,5,14,10,10
10,10,10,11,14,10,2,11,7,7,7,5,6,10,10,10
10,10,10,10,10,10,10,10,10,10,11,4,10,10,10,10
10,10,11,14,10,11,15,12,8,8,11,4,11,14,11,14
9,13,12,8,9,12,9,5,5,5,13,5,12,9,12,8
