16
1,7,5,5,5,7,5,4,2,3,5,5,5,5,7,4
2,11,5,5,7,13,5,6,11,14,2,1,5,5,15,4
10,11,7,5,13,5,5,14,10,10,11,5,5,5,13,6
11,15,15,7,5,5,5,13,12,11,15,5,7,5,5,12
8,8,9,13,7,5,7,5,5,12,9,5,15,7,5,4
1,7,6,3,14,3,15,6,1,6,3,5,13,13,7,4
3,14,11,14,11,14,10,11,5,15,13,7,5,5,13,6
10,10,10,10,10,10,10,11,6,10,1,13,7,5,4,10
10,11,14,10,10,10,10,9,12,10,3,7,14,2,2,10
10,10,11,15,14,10,11,4,2,11,14,8,11,14,10,10
10,10,10,8,9,12,11,5,14,10,10,2,10,11,14,10
9,13,13,7,6,2,9,6,10,10,10,10,10,8,9,14
2,2,2,10,10,10,2,10,10,10,10,10,11,5,5,14
10,10,11,14,11,14,11,12,11,12,9,15,12,1,7,12
11,13,14,10,10,10,10,2,11,6,2,11,7,6,11,4
8,1,12,8,8,9,13,13,12,9,13,12,8,9,13,4
