16
1,7,5,5,5,5,6,3,5,5,5,5,4,2,2,2
2,11,7,5,5,4,8,11,5,5,5,5,7,13,15,14
9,13,15,5,7,5,5,13,6,1,5,7,13,6,10,10
1,7,13,5,13,5,6,3,12,1,5,13,4,10,10,10
1,13,5,5,7,6,8,9,6,3,5,5,7,13,12,10
3,7,7,5,14,8,2,3,14,10,1,7,13,5,4,10
8,10,10,1,15,4,11,12,11,15,5,13,5,7,4,10
2,10,10,1,13,6,10,3,14,10,3,5,7,13,5,12
11,14,11,7,7,14,10,9,12,10,9,7,13,5,5,6
10,11,14,10,10,9,15,7,7,15,5,13,5,5,5,12
10,10,10,10,10,3,14,10,10,11,7,7,7,7,6,2
10,11,14,10,10,8,10,8,11,14,10,11,14,10,10,10
10,10,11,14,10,1,13,6,10,10,10,10,10,10,10,10
10,10,10,10,10,1,7,13,14,10,10,10,10,8,10,10
8,10,10,11,14,1,15,4,10,11,14,10,10,3,15,14
1,12,8,8,8,1,13,5,12,8,9,12,9,12,9,12
