16
1,7,5,4,2,3,4,3,5,5,6,2,3,6,3,6
3,13,7,6,10,9,6,10,3,6,10,10,10,11,12,10
9,7,14,11,15,5,13,13,12,10,11,12,10,9,6,10
2,10,10,10,9,6,3,5,7,14,11,4,11,6,10,10
10,10,10,11,6,11,14,1,14,11,13,7,14,11,14,10
9,14,11,14,10,10,10,1,14,10,1,13,12,8,10,10
3,12,8,8,11,12,10,1,13,14,2,3,7,5,12,10
10,1,7,5,12,3,14,3,6,10,11,12,9,7,5,12
10,3,15,6,2,10,10,11,12,9,13,6,2,10,3,6
10,8,8,10,11,14,11,12,3,7,5,13,13,13,12,10
11,7,6,10,10,10,11,5,13,14,2,2,3,5,7,12
11,12,11,15,15,12,9,4,1,13,14,11,14,2,11,6
10,2,11,14,10,3,5,5,5,5,15,14,10,11,12,10
10,11,12,11,15,13,5,4,3,4,11,14,10,10,2,10
10,11,6,8,9,5,7,5,13,5,14,8,11,15,12,10
8,8,8,1,5,5,13,4,1,5,13,5,12,9,4,8
