16
1,7,7,5,5,7,5,5,6,2,2,3,6,3,6,2
2,10,9,6,1,13,5,6,10,10,10,10,10,10,11,14
10,10,3,12,2,2,2,10,10,10,10,10,9,12,8,8
10,10,11,4,10,10,11,14,11,15,14,9,5,5,5,6
10,10,9,7,15,15,12,8,8,8,11,5,6,3,5,14
11,13,5,12,8,11,5,5,5,5,14,3,14,9,6,10
9,7,5,5,7,12,3,5,5,6,9,14,8,1,14,10
3,15,7,4,9,5,12,3,6,10,3,13,4,1,14,10
10,9,13,7,5,5,6,11,12,9,13,5,7,5,14,8
10,2,3,15,6,2,10,11,4,3,5,5,15,7,13,4
10,11,12,8,9,12,11,15,7,14,3,7,14,9,5,6
11,14,1,5,7,5,12,11,14,10,11,14,9,7,5,12
10,11,6,1,15,5,4,10,11,14,10,10,3,15,5,6
10,10,10,3,13,6,2,10,10,10,10,10,8,11,4,10
10,10,9,13,6,9,12,10,10,11,14,11,7,13,4,8
9,12,1,5,13,5,5,12,8,8,8,8,9,5,5,4
